32 15
0000 0000 0000 0000 0000 0000 0000 0000 0000 0000 0000 0000 0000 0000 0000 0000 0000 0000 0000 0000 0000 0000 0000 0000 0000 0000 0000 0000 0000 0000 0000 0000
0000 0000 0000 0000 0000 0000 0000 0000 0000 0000 0000 0000 0000 0000 0000 0000 0000 0000 0000 0000 0000 0000 0000 0000 0000 0000 0000 0000 0000 0000 0000 0000
0000 0000 0000 0000 0000 0000 0000 0000 0000 0000 0000 0000 0000 0000 0000 0000 0000 0000 0000 0000 0000 0000 0000 0000 0000 0000 0000 0000 0000 0000 0000 0000
0016 0016 0016 0016 0016 0016 0016 0016 0016 0016 0016 0016 0016 0016 0016 0016 0016 0016 0016 0016 0016 0016 0016 0016 0016 0016 0016 0016 0016 0016 0016 0016
0000 0000 0000 0000 0000 0000 0000 0000 0000 0000 0000 0000 0000 0000 0000 0000 0000 0000 0000 0000 0000 0000 0000 0000 0000 0000 0000 0000 0000 0000 0000 0000
0000 0000 0000 0000 0000 0000 0000 0000 0000 0000 0000 0000 0000 0000 0000 0000 0000 0000 0000 0000 0000 0000 0000 0000 0000 0000 0000 0000 0000 0000 0000 0000
0000 0000 0000 0000 0000 0000 0000 0000 0000 0000 0000 0000 0000 0000 0000 0000 0000 0000 0000 0000 0000 0000 0000 0000 0000 0000 0000 0000 0000 0000 0000 0000
0000 0000 0000 0000 0000 0000 0000 0000 0000 0000 0000 0000 0000 0000 0000 0000 0000 0000 0000 0000 0000 0000 0000 0000 0000 0000 0000 0000 0000 0000 0000 0000
0000 0000 0000 0000 0000 0000 0000 0000 0000 0000 0000 0000 0000 0000 0000 0000 0000 0000 0000 0000 0000 0000 0000 0000 0000 0000 0000 0000 0000 0000 0000 0000
0000 0000 0000 0000 0000 0000 0000 0000 0000 0000 0000 0000 0000 0000 0000 0000 0000 0000 0000 0000 0000 0000 0000 0000 0000 0000 0000 0000 0000 0000 0000 0000
0000 0000 0000 0000 0000 0000 0000 0000 0000 0000 0000 0000 0000 0000 0000 0000 0000 0000 0000 0000 0000 0000 0000 0000 0000 0000 0000 0000 0000 0000 0000 0000
0000 0000 0000 0000 0000 0000 0000 0000 0000 0000 0000 0000 0000 0000 0000 0000 0000 0000 0000 0000 0000 0000 0000 0000 0000 0000 0000 0000 0000 0000 0000 0000
0000 0000 0000 0000 0000 0000 0000 0000 0000 0000 0000 0000 0000 0000 0000 0000 0000 0000 0000 0000 0000 0000 0000 0000 0000 0000 0000 0000 0000 0000 0000 0000
0000 0000 0000 0000 0000 0000 0000 0000 0000 0000 0000 0000 0000 0000 0000 0000 0000 0000 0000 0000 0000 0000 0000 0000 0000 0000 0000 0000 0000 0000 0000 0000
0000 0000 0000 0000 0000 0000 0000 0000 0000 0000 0000 0000 0000 0000 0000 0000 0000 0000 0000 0000 0000 0000 0000 0000 0000 0000 0000 0000 0000 0000 0000 0000
-----
0016 0016 0016 0016 0016 0016 0016 0016 0016 0016 0016 0016 0016 0016 0016 0016 0016 0016 0016 0016 0016 0016 0016 0016 0016 0016 0016 0016 0016 0016 0016 0016
2048 2049 2049 2049 2049 2049 2049 2049 2049 2049 2049 2049 2049 2049 2049 2049 2049 2049 2049 2049 2049 2049 2049 2049 2049 2049 2049 2049 2049 2049 2049 2050
2112 2113 2113 2113 2113 2113 2113 2113 2113 2113 2113 2113 2113 2113 2113 2113 2113 2113 2113 2113 2113 2113 2113 2113 2113 2113 2113 2113 2113 2113 2113 2114
2112 2113 2113 2113 2113 2113 2113 2113 2113 2113 2113 2113 2113 2113 2113 2113 2113 2113 2113 2113 2113 2113 2113 2113 2113 2113 2113 2113 2113 2113 2113 2114
2112 2113 2113 2113 2113 2113 2113 2113 2113 2113 2113 2113 2113 2113 2113 2113 2113 2113 2113 2113 2113 2113 2113 2113 2113 2113 2113 2113 2113 2113 2113 2114
2112 2113 2113 2113 2113 2113 2113 2113 2113 2113 2113 2113 2113 2113 2113 2113 2113 2113 2113 2113 2113 2113 2113 2113 2113 2113 2113 2113 2113 2113 2113 2114
2112 2113 2113 2113 2113 2113 2113 2113 2113 2113 2113 2113 2113 2113 2113 2113 2113 2113 2113 2113 2113 2113 2113 2113 2113 2113 2113 2113 2113 2113 2113 2114
2112 2113 2113 2113 2113 2113 2113 2113 2113 2113 2113 2113 2113 2113 2113 2113 2113 2113 2113 2113 2113 2113 2113 2113 2113 2113 2113 2113 2113 2113 2113 2114
2112 2113 2113 2113 2113 2113 2113 2113 2113 2113 2113 2113 2113 2113 2113 2113 2113 2113 2113 2113 2113 2113 2113 2113 2113 2113 2113 2113 2113 2113 2113 2114
2112 2113 2113 2113 2113 2113 2113 2113 2113 2113 2113 2113 2113 2113 2113 2113 2113 2113 2113 2113 2113 2113 2113 2113 2113 2113 2113 2113 2113 2113 2113 2114
2112 2113 2113 2113 2113 2113 2113 2113 2113 2113 2113 2113 2113 2113 2113 2113 2113 2113 2113 2113 2113 2113 2113 2113 2113 2113 2113 2113 2113 2113 2113 2114
2112 2113 2113 2113 2113 2113 2113 2113 2113 2113 2113 2113 2113 2113 2113 2113 2113 2113 2113 2113 2113 2113 2113 2113 2113 2113 2113 2113 2113 2113 2113 2114
2112 2113 2113 2113 2113 2113 2113 2113 2113 2113 2113 2113 2113 2113 2113 2113 2113 2113 2113 2113 2113 2113 2113 2113 2113 2113 2113 2113 2113 2113 2113 2114
2112 2113 2113 2113 2113 2113 2113 2113 2113 2113 2113 2113 2113 2113 2113 2113 2113 2113 2113 2113 2113 2113 2113 2113 2113 2113 2113 2113 2113 2113 2113 2114
2176 2177 2177 2177 2177 2177 2177 2177 2177 2177 2177 2177 2177 2177 2177 2177 2177 2177 2177 2177 2177 2177 2177 2177 2177 2177 2177 2177 2177 2177 2177 2178
-----
4106 4106 4106 4106 4106 4106 4106 4106 4106 4106 4106 4106 4106 4106 4106 4106 4106 4106 4106 4106 4106 4106 4106 4106 4106 4106 4106 4106 4106 4106 4106 4106
4108 4234 4234 4234 4234 4234 4234 4234 4234 4234 4234 4234 4234 4234 4234 4234 4234 4234 4234 4234 4234 4234 4234 4234 4234 4234 4234 4234 4234 4234 4234 4108
4234 0000 0000 0000 0000 0000 0000 0000 0000 0000 0000 0000 0000 0000 0000 0000 0000 0000 0000 0000 0000 0000 0000 0000 0000 0000 0000 0000 0000 0000 0000 4234
4106 6184 0000 0000 0000 6184 0000 6184 0000 0000 0000 6184 0000 6184 0000 0000 0000 6184 0000 6184 0000 0000 0000 6184 0000 6184 0000 6184 0000 0000 0000 4106
4108 0000 0000 0000 0000 0000 0000 0000 0000 0000 0000 0000 0000 0000 0000 0000 0000 0000 0000 0000 0000 0000 0000 0000 0000 0000 0000 0000 0000 0000 0000 4108
4108 0000 0000 0000 0000 0000 0000 0000 0000 0000 0000 0000 0000 0000 0000 0000 0000 0000 0000 0000 0000 0000 0000 0000 0000 0000 0000 0000 0000 0000 0000 4108
4234 0000 0000 0000 0000 0000 0000 0000 0000 0000 0000 0000 0000 0000 0000 0000 0000 0000 0000 0000 0000 0000 0000 0000 0000 0000 0000 0000 0000 0000 0000 4234
4106 0000 0000 0000 0000 0000 0000 0000 0000 0000 0000 0000 0000 0000 0000 0000 0000 0000 0000 0000 0000 0000 0000 0000 0000 0000 0000 0000 0000 0000 0000 4106
4108 0000 0000 0000 0000 0000 0000 0000 0000 0000 0000 0000 0000 0000 0000 0000 0000 0000 0000 0000 0000 0000 0000 0000 0000 0000 0000 0000 0000 0000 0000 4108
4108 0000 0000 0000 0000 0000 0000 0000 0000 0000 0000 0000 0000 0000 0000 0000 0000 0000 0000 0000 0000 0000 0000 0000 0000 0000 0000 0000 0000 0000 0000 4108
4108 0000 0000 0000 0000 0000 0000 0000 0000 0000 0000 0000 0000 0000 0000 0000 0000 0000 0000 0000 0000 0000 0000 0000 0000 0000 0000 0000 0000 0000 0000 4108
4108 0000 0000 0000 0000 0000 0000 0000 0000 0000 0000 0000 0000 0000 0000 0000 0000 0000 0000 0000 0000 0000 0000 0000 0000 0000 0000 0000 0000 0000 0000 4108
4108 0000 0000 0000 0000 0000 0000 0000 0000 0000 0000 0000 0000 0000 0000 0000 0000 0000 0000 0000 0000 0000 0000 0000 0000 0000 0000 0000 0000 0000 0000 4108
4108 4106 4106 4106 4106 4106 4106 4106 4106 4106 4106 4106 4106 4106 4106 4106 4106 4106 4106 4106 4106 4106 4106 4106 4106 4106 4106 4106 4106 4106 4106 4108
4234 4234 4234 4234 4234 4234 4234 4234 4234 4234 4234 4234 4234 4234 4234 4234 4234 4234 4234 4234 4234 4234 4234 4234 4234 4234 4234 4234 4234 4234 4234 4234
