25 14
0016 0016 0016 0016 0016 0016 0016 0016 0016 0016 0016 0016 0016 0016 0016 0016 0016 0016 0016 0016 0016 0016 0016 0016 0016
0266 0266 0266 0266 0266 0266 0266 0266 0266 0266 0266 0266 0266 0266 0266 0266 0266 0266 0266 0266 0266 0266 0266 0266 0266
0266 0266 0266 0266 0266 0266 0266 0266 0266 0266 0266 0266 0266 0266 0266 0266 0266 0266 0266 0266 0266 0266 0266 0266 0266
0266 0266 0266 0266 0266 0266 0266 0266 0266 0266 0266 0266 0266 0266 0266 0266 0266 0266 0266 0266 0266 0266 0266 0266 0266
0266 0266 0266 0266 0266 0266 0266 0266 0266 0266 0266 0266 0266 0266 0266 0266 0266 0266 0266 0266 0266 0266 0266 0266 0266
0266 0266 0266 0266 0266 0266 0266 0266 0266 0266 0266 0266 0266 0266 0266 0266 0266 0266 0266 0266 0266 0266 0266 0266 0266
0266 0266 0266 0266 0266 0266 0266 0266 0266 0266 0266 0266 0266 0266 0266 0266 0266 0266 0266 0266 0266 0266 0266 0266 0266
0266 0266 0266 0266 0266 0266 0266 0266 0266 0266 0266 0266 0266 0266 0266 0266 0266 0266 0266 0266 0266 0266 0266 0266 0266
0266 0266 0266 0266 0266 0266 0266 0266 0266 0266 0266 0266 0266 0266 0266 0266 0266 0266 0266 0266 0266 0266 0266 0266 0266
0266 0266 0266 0266 0266 0266 0266 0266 0266 0266 0266 0266 0266 0266 0266 0266 0266 0266 0266 0266 0266 0266 0266 0266 0266
0016 0016 0016 0016 0016 0016 0016 0016 0016 0016 0016 0016 0016 0016 0016 0016 0016 0016 0016 0016 0016 0016 0016 0016 0016
0016 0016 0016 0016 0016 0016 0016 0016 0016 0016 0016 0016 0016 0016 0016 0016 0016 0016 0016 0016 0016 0016 0016 0016 0016
0016 0016 0016 0016 0016 0016 0016 0016 0016 0016 0016 0016 0016 0016 0016 0016 0016 0016 0016 0016 0016 0016 0016 0016 0016
0016 0016 0016 0016 0016 0016 0016 0016 0016 0016 0016 0016 0016 0016 0016 0016 0016 0016 0016 0016 0016 0016 0016 0016 0016
-----
7720 7722 0000 0000 0000 0000 0000 0000 0000 0000 0000 0000 0000 0000 0000 0000 0000 0000 0000 0000 0000 0000 0000 7720 7722
7848 7850 0181 0181 0181 0181 0181 0181 0181 0181 0181 0181 0181 0181 0181 0181 0181 0181 0181 0181 0181 0181 0181 7848 7850
0436 0438 0309 0309 0309 0309 0309 0309 0309 0309 0309 0309 0309 0309 0309 0309 0309 0309 0309 0309 0309 0309 0309 0436 0438
0565 0565 0565 0565 0565 0565 0565 0565 0565 0565 0565 0565 0565 0565 0565 0565 0565 0565 0565 0565 0565 0565 0565 0565 0566
0000 0000 0000 0000 0000 0000 0000 0000 0000 0000 0000 0000 0000 0000 0000 0000 0000 0000 0000 0000 0000 0000 0000 0000 0000
0000 0000 0000 0000 0000 0000 0000 0000 0000 0000 0000 0000 0000 0000 0000 0000 0000 0000 0000 0000 0000 0000 0000 0000 0000
7720 7722 0000 0000 0000 0000 0000 0000 0000 0000 0000 0000 0000 0000 0000 0000 0000 0000 0000 0000 0000 0000 0000 7720 7722
7848 7850 0181 0181 0181 0181 0181 0181 0181 0181 0181 0181 0181 0181 0181 0181 0181 0181 0181 0181 0181 0181 0181 7848 7850
0436 0438 0309 0309 0309 0309 0309 0309 0309 0309 0309 0309 0309 0309 0309 0309 0309 0309 0309 0309 0309 0309 0309 0436 0438
0565 0501 0501 0501 0501 0501 0501 0501 0501 0501 0501 0501 0501 0501 0501 0501 0501 0501 0501 0501 0501 0501 0501 0501 0566
0565 0501 0501 0501 0501 0501 0501 0501 0501 0501 0501 0501 0501 0501 0501 0501 0501 0501 0501 0501 0501 0501 0501 0501 0566
0565 0501 0501 0501 0501 0501 0501 0501 0501 0501 0501 0501 0501 0501 0501 0501 0501 0501 0501 0501 0501 0501 0501 0501 0566
0565 0501 0501 0501 0501 0501 0501 0501 0501 0501 0501 0501 0501 0501 0501 0501 0501 0501 0501 0501 0501 0501 0501 0501 0566
0565 0501 0501 0501 0501 0501 0501 0501 0501 0501 0501 0501 0501 0501 0501 0501 0501 0501 0501 0501 0501 0501 0501 0501 0566
-----
0000 0000 0000 0000 0000 0000 0000 0000 0000 0000 0000 0000 0000 0000 0000 0000 0000 0000 0000 0000 0000 0000 0000 0000 0000
0000 0000 2970 0000 0000 0000 0000 0000 0000 0000 0000 0000 0000 0000 0000 0000 0000 0000 0000 0000 0000 0000 0000 0000 0000
0000 0000 2970 0000 0000 0000 0000 0000 0000 0000 0000 0000 0000 0000 0000 0000 0000 0000 0000 0000 0000 0000 0000 0000 0000
0000 0000 0000 7478 0000 0000 7478 0000 0000 7478 0000 0000 7478 0000 0000 7478 0000 0000 7478 0000 0000 7478 0000 0000 0000
0000 0000 0000 7606 0000 0000 7606 0000 0000 7606 0000 0000 7606 0000 0000 7606 0000 0000 7606 0000 0000 7606 0000 0000 0000
0000 0000 0000 0000 0000 0000 0000 0000 0000 0000 0000 0000 0000 0000 0000 0000 0000 0000 0000 0000 0000 0000 0000 0000 0000
0000 0000 0000 0000 0000 0000 0000 0000 0000 0000 0000 0000 0000 0000 0000 0000 0000 0000 0000 0000 0000 0000 0000 0000 0000
0000 0000 2970 0000 0000 0000 0000 0000 0000 0000 0000 0000 0000 0000 0000 0000 0000 0000 0000 0000 0000 0000 0000 0000 0000
6452 6452 2970 0000 0000 0000 0000 0000 0000 0000 0000 0000 0000 0000 0000 0000 0000 0000 0000 0000 0000 0000 0000 6452 6452
6580 6580 0000 0000 0000 0000 0000 0000 0000 0000 0000 0000 0000 0000 0000 0000 0000 0000 0000 0000 0000 0000 0000 6580 6580
0000 0000 0000 0000 0000 0000 0000 0000 0000 0000 0000 0000 0000 0000 0000 0000 0000 0000 0000 0000 0000 0000 0000 0000 0000
0000 0000 0000 7822 0000 0000 7822 0000 0000 7822 0000 0000 7822 0000 0000 7822 0000 0000 7822 0000 0000 7822 0000 0000 0000
0000 0000 0000 7950 0000 0000 7950 0000 0000 7950 0000 0000 7950 0000 0000 7950 0000 0000 7950 0000 0000 7950 0000 0000 0000
0000 0000 0000 0000 0000 0000 0000 0000 0000 0000 0000 0000 0000 0000 0000 0000 0000 0000 0000 0000 0000 0000 0000 0000 0000
