17 9
0016 0016 0016 0016 0016 0016 0016 0016 0016 0016 0016 0016 0016 0016 0016 0016 0016 
0016 0516 0516 0516 0516 0516 0516 0516 0516 0516 0516 0516 0516 0516 0516 0516 0516 
0016 0516 0516 0516 0516 0516 0516 0516 0516 0516 0516 0516 0516 0516 0516 0516 0516 
0016 0516 0516 0516 0516 0516 0516 0516 0516 0516 0516 0516 0516 0516 0516 0516 0516 
0016 0516 0516 0516 0516 0516 0516 0516 0516 0516 0516 0516 0516 0516 0516 0516 0516 
0016 0516 0516 0516 0516 0516 0516 0516 0516 0516 0516 0516 0516 0516 0516 0516 0516 
0016 0516 0516 0516 0516 0516 0516 0516 0516 0516 0516 0516 0516 0516 0516 0516 0516 
0016 0516 0516 0516 0516 0516 0516 0516 0516 0516 0516 0516 0516 0516 0516 0516 0516 
0016 0516 0516 0516 0516 0516 0516 0516 0516 0516 0516 0516 0516 0516 0516 0516 0516
-----
0177 0177 0177 0177 0177 0177 0177 0177 0177 0177 0177 0177 0177 0177 0177 0177 0177
0241 0432 0433 0433 0434 0177 0432 0433 0433 0433 0433 0433 0433 0433 0433 0434 0241 
0241 0000 0000 0000 0000 0177 0560 0560 0560 0560 0560 0560 0560 0560 0560 0560 0241 
0241 0000 0000 0000 0000 0177 0000 0000 0000 0000 0000 0000 0000 0000 0000 0000 0241 
0241 0000 0000 0000 0000 0432 0000 0000 0000 0000 0000 0000 0000 0000 0000 0000 0241 
0241 0000 0000 0000 0000 0560 0000 0000 0000 0000 0000 0000 0000 0000 0000 0000 0241 
0241 0000 0000 0000 0000 0000 0000 0000 0000 0000 0000 0000 0000 0000 0000 0000 0241 
0305 0305 0305 0305 0305 0305 0305 0305 0305 0305 0305 0305 0305 0000 0305 0305 0305
0432 0433 0433 0433 0433 0433 0433 0433 0433 0433 0433 0433 0433 0000 0433 0433 0434 
-----
0000 0000 0000 0000 0000 0000 0000 0000 0000 0000 0000 0000 0000 0000 0000 0000 0000 
0000 0000 0000 0000 0000 0000 0000 0000 0000 0000 0000 0000 0000 0000 0000 0000 0000
0000 4896 4898 4900 4902 0000 0000 0000 0000 0000 0000 0000 0000 0000 0000 0000 0000 
0000 5024 5026 5028 5030 0000 2972 5526 5528 5528 5530 0000 0000 0000 0000 0000 0000 
0000 4920 0000 0000 0000 0000 2972 0000 0000 0000 0000 0000 0000 0000 0000 0000 0000 
0000 5048 0000 0000 0000 0000 2972 0000 0000 0000 0000 0000 0000 0000 0000 0000 0000 
0000 5176 0000 0000 0000 0000 0000 0000 0000 0000 0000 0000 0000 0000 0000 0000 0000 
0000 0000 0000 0000 0000 0000 0000 0000 0000 0000 0000 0000 0000 0000 0000 0000 0000 
0000 0000 0000 0000 0000 0000 0000 0000 0000 0000 0000 0000 0000 2972 0000 0000 0000 
