25 25
0016 0016 0016 0016 0016 0016 0016 0016 0016 0016 0016 0016 0016 0016 0016 0016 0016 0016 0016 0016 0016 0016 0016 0016 0016
0016 0008 0008 0008 0008 0008 0008 0008 0008 0008 0008 0008 0008 0008 0008 0008 0008 0008 0008 0008 0008 0008 0008 0008 0016
0016 0008 0008 0008 0008 0008 0008 0008 0008 0008 0008 0008 0008 0008 0008 0008 0008 0008 0008 0008 0008 0008 0008 0008 0016
0016 0008 0008 0008 0008 0008 0008 0008 0008 0008 0008 0008 0008 0008 0008 0008 0008 0008 0008 0008 0008 0008 0008 0008 0016
0016 0008 0008 0008 0008 0008 0008 0008 0008 0008 0008 0008 0008 0008 0008 0008 0008 0008 0008 0008 0008 0008 0008 0008 0016
0016 0008 0008 0008 0008 0008 0008 0008 0008 0008 0008 0008 0008 0008 0008 0008 0008 0008 0008 0008 0008 0008 0008 0008 0016
0016 0008 0008 0008 0008 0008 0008 0008 0008 0008 0008 0008 0008 0008 0008 0008 0008 0008 0008 0008 0008 0008 0008 0008 0016
0016 0008 0008 0008 0008 0008 0008 0008 0008 0008 0008 0008 0008 0008 0008 0008 0008 0008 0008 0008 0008 0008 0008 0008 0016
0016 0008 0008 0008 0008 0008 0008 0008 0008 0008 0008 0008 0008 0008 0008 0008 0008 0008 0008 0008 0008 0008 0008 0008 0016
0016 0008 0008 0008 0008 0008 0008 0008 0008 0008 0008 0008 0008 0008 0008 0008 0008 0008 0008 0008 0008 0008 0008 0008 0016
0016 0008 0008 0008 0008 0008 0008 0008 0008 0008 0008 0008 0008 0008 0008 0008 0008 0008 0008 0008 0008 0008 0008 0008 0016
0016 0008 0008 0008 0008 0008 0008 0008 0008 0008 0008 0008 0008 0008 0008 0008 0008 0008 0008 0008 0008 0008 0008 0008 0016
0008 0008 0008 0008 0008 0008 0008 0008 0008 0008 0008 0008 0008 0008 0008 0008 0008 0008 0008 0008 0008 0008 0008 0008 0008
0016 0008 0008 0008 0008 0008 0008 0008 0008 0008 0008 0008 0008 0008 0008 0008 0008 0008 0008 0008 0008 0008 0008 0008 0016
0016 0008 0008 0008 0008 0008 0008 0008 0008 0008 0008 0008 0008 0008 0008 0008 0008 0008 0008 0008 0008 0008 0008 0008 0016
0016 0008 0008 0008 0008 0008 0008 0008 0008 0008 0008 0008 0008 0008 0008 0008 0008 0008 0008 0008 0008 0008 0008 0008 0016
0016 0008 0008 0008 0008 0008 0008 0008 0008 0008 0008 0008 0008 0008 0008 0008 0008 0008 0008 0008 0008 0008 0008 0008 0016
0016 0008 0008 0008 0008 0008 0008 0008 0008 0008 0008 0008 0008 0008 0008 0008 0008 0008 0008 0008 0008 0008 0008 0008 0016
0016 0008 0008 0008 0008 0008 0008 0008 0008 0008 0008 0008 0008 0008 0008 0008 0008 0008 0008 0008 0008 0008 0008 0008 0016
0016 0008 0008 0008 0008 0008 0008 0008 0008 0008 0008 0008 0008 0008 0008 0008 0008 0008 0008 0008 0008 0008 0008 0008 0016
0016 0008 0008 0008 0008 0008 0008 0008 0008 0008 0008 0008 0008 0008 0008 0008 0008 0008 0008 0008 0008 0008 0008 0008 0016
0016 0008 0008 0008 0008 0008 0008 0008 0008 0008 0008 0008 0008 0008 0008 0008 0008 0008 0008 0008 0008 0008 0008 0008 0016
0016 0008 0008 0008 0008 0008 0008 0008 0008 0008 0008 0008 0008 0008 0008 0008 0008 0008 0008 0008 0008 0008 0008 0008 0016
0016 0008 0008 0008 0008 0008 0008 0008 0008 0008 0008 0008 0008 0008 0008 0008 0008 0008 0008 0008 0008 0008 0008 0008 0016
0016 0016 0016 0016 0016 0016 0016 0016 0016 0016 0016 0016 0016 0016 0016 0016 0016 0016 0016 0016 0016 0016 0016 0016 0016
-----
0000 0000 0000 0000 0000 0000 0000 0000 0000 0000 0000 0000 0000 0000 0000 0000 0000 0000 0000 0000 0000 0000 0000 0000 0000 
0000 0000 0000 0000 0000 0000 0000 0000 0000 0000 0000 0000 0000 0000 0000 0000 0000 0000 0000 0000 0000 0000 0000 0000 0000
0000 0000 0000 0000 0000 0000 0000 0000 0000 0000 0000 0000 0000 0000 0000 0000 0000 0000 0000 0000 0000 0000 0000 0000 0000
0000 0000 0000 0000 0000 0000 0000 0000 0000 0000 0000 0000 0000 0000 0000 0000 0000 0000 0000 0000 0000 0000 0000 0000 0000
0000 0000 0000 0000 0000 0000 0000 0000 0000 0000 0000 0000 0000 0000 0000 0000 0000 0000 0000 0000 0000 0000 0000 0000 0000
0000 0000 0000 0000 0000 0000 0000 0000 0000 0000 0000 0000 0000 0000 0000 0000 0000 0000 0000 0000 0000 0000 0000 0000 0000
0000 0000 0000 0000 0000 0000 0000 0000 0000 0000 0000 0000 0000 0000 0000 0000 0000 0000 0000 0000 0000 0000 0000 0000 0000
0000 0000 0000 7976 0000 0000 0000 0000 7976 0000 0000 0000 0000 0000 7976 0000 0000 7976 7976 7976 7976 0000 0000 0000 0000
0000 0000 0000 7976 0000 0000 0000 0000 0000 7976 0000 0000 0000 7976 0000 0000 7976 0000 0000 0000 7976 7976 0000 0000 0000
0000 0000 0000 7976 0000 0000 0000 0000 0000 0000 7976 7976 7976 0000 0000 0000 7976 0000 0000 0000 0000 7976 0000 0000 0000
0000 0000 0000 7976 0000 0000 0000 0000 0000 0000 0000 7976 0000 0000 0000 0000 7976 0000 0000 0000 0000 0000 0000 0000 0000
0000 0000 0000 7976 0000 0000 0000 0000 0000 0000 0000 7976 0000 0000 0000 0000 7976 7976 7976 7976 0000 0000 0000 0000 0000
0000 0000 0000 7976 0000 0000 0000 0000 0000 0000 0000 7976 0000 0000 0000 0000 0000 0000 0000 7976 7976 0000 0000 0000 0000
0000 0000 0000 7976 0000 0000 0000 0000 0000 0000 0000 7976 0000 0000 0000 0000 0000 0000 0000 0000 7976 7976 0000 0000 0000
0000 0000 0000 7976 0000 0000 0000 0000 0000 0000 0000 7976 0000 0000 0000 0000 0000 0000 0000 0000 0000 7976 0000 0000 0000
0000 0000 0000 7976 0000 0000 0000 0000 0000 0000 0000 7976 0000 0000 0000 0000 7976 0000 0000 0000 0000 7976 0000 0000 0000
0000 0000 0000 7976 7976 7976 7976 7976 0000 0000 0000 7976 0000 0000 0000 0000 7976 7976 0000 0000 7976 7976 0000 0000 0000
0000 0000 0000 7976 7976 7976 7976 7976 0000 0000 0000 7976 0000 0000 0000 0000 0000 7976 7976 7976 7976 0000 0000 0000 0000
0000 0000 0000 0000 0000 0000 0000 0000 0000 0000 0000 0000 0000 0000 0000 0000 0000 0000 0000 0000 0000 0000 0000 0000 0000
0000 0000 0000 0000 0000 0000 0000 0000 0000 0000 0000 0000 0000 0000 0000 0000 0000 0000 0000 0000 0000 0000 0000 0000 0000
0000 0000 0000 0000 0000 0000 0000 0000 0000 0000 0000 0000 0000 0000 0000 0000 0000 0000 0000 0000 0000 0000 0000 0000 0000
0000 0000 0000 0000 0000 0000 0000 0000 0000 0000 0000 0000 0000 0000 0000 0000 0000 0000 0000 0000 0000 0000 0000 0000 0000
0000 0000 0000 0000 0000 0000 0000 0000 0000 0000 0000 0000 0000 0000 0000 0000 0000 0000 0000 0000 0000 0000 0000 0000 0000
0000 0000 0000 0000 0000 0000 0000 0000 0000 0000 0000 0000 0000 0000 0000 0000 0000 0000 0000 0000 0000 0000 0000 0000 0000
0000 0000 0000 0000 0000 0000 0000 0000 0000 0000 0000 0000 0000 0000 0000 0000 0000 0000 0000 0000 0000 0000 0000 0000 0000
-----
0000 0000 0000 0000 0000 0000 0000 0000 0000 0000 0000 0000 0000 0000 0000 0000 0000 0000 0000 0000 0000 0000 0000 0000 0000
0000 0000 0000 0000 0000 0000 0000 0000 0000 0000 0000 0000 0000 0000 0000 0000 0000 0000 0000 0000 0000 0000 0000 0000 0000
0000 0000 0000 0000 0000 0000 0000 0000 0000 0000 0000 0000 0000 0000 0000 0000 0000 0000 0000 0000 0000 0000 0000 0000 0000
0000 0000 0000 0000 0000 0000 0000 0000 0000 0000 0000 0000 0000 0000 0000 0000 0000 0000 0000 0000 0000 0000 0000 0000 0000
0000 0000 0000 0000 0000 0000 0000 0000 0000 0000 0000 0000 0000 0000 0000 0000 0000 0000 0000 0000 0000 0000 0000 0000 0000
0000 0000 0000 0000 0000 0000 0000 0000 0000 0000 0000 0000 0000 0000 0000 0000 0000 0000 0000 0000 0000 0000 0000 0000 0000
0000 0000 0000 0000 0000 0000 0000 0000 0000 0000 0000 0000 0000 0000 0000 0000 0000 0000 0000 0000 0000 0000 0000 0000 0000
0000 0000 0000 0000 0000 0000 0000 0000 0000 0000 0000 0000 0000 0000 0000 0000 0000 0000 0000 0000 0000 0000 0000 0000 0000
0000 0000 0000 0000 0000 0000 0000 0000 0000 0000 0000 0000 0000 0000 0000 0000 0000 0000 0000 0000 0000 0000 0000 0000 0000
0000 0000 0000 0000 0000 0000 0000 0000 0000 0000 0000 0000 0000 0000 0000 0000 0000 0000 0000 0000 0000 0000 0000 0000 0000
0000 0000 0000 0000 0000 0000 0000 0000 0000 0000 0000 0000 0000 0000 0000 0000 0000 0000 0000 0000 0000 0000 0000 0000 0000
0000 0000 0000 0000 0000 0000 0000 0000 0000 0000 0000 0000 0000 0000 0000 0000 0000 0000 0000 0000 0000 0000 0000 0000 0000
0000 0000 0000 0000 0000 0000 0000 0000 0000 0000 0000 0000 0000 0000 0000 0000 0000 0000 0000 0000 0000 0000 0000 0000 0000
0000 0000 0000 0000 0000 0000 0000 0000 0000 0000 0000 0000 0000 0000 0000 0000 0000 0000 0000 0000 0000 0000 0000 0000 0000
0000 0000 0000 0000 0000 0000 0000 0000 0000 0000 0000 0000 0000 0000 0000 0000 0000 0000 0000 0000 0000 0000 0000 0000 0000
0000 0000 0000 0000 0000 0000 0000 0000 0000 0000 0000 0000 0000 0000 0000 0000 0000 0000 0000 0000 0000 0000 0000 0000 0000
0000 0000 0000 0000 0000 0000 0000 0000 0000 0000 0000 0000 0000 0000 0000 0000 0000 0000 0000 0000 0000 0000 0000 0000 0000
0000 0000 0000 0000 0000 0000 0000 0000 0000 0000 0000 0000 0000 0000 0000 0000 0000 0000 0000 0000 0000 0000 0000 0000 0000
0000 0000 0000 0000 0000 0000 0000 0000 0000 0000 0000 0000 0000 0000 0000 0000 0000 0000 0000 0000 0000 0000 0000 0000 0000
0000 0000 0000 0000 0000 0000 0000 0000 0000 0000 0000 0000 0000 0000 0000 0000 0000 0000 0000 0000 0000 0000 0000 0000 0000
0000 0000 0000 0000 0000 0000 0000 0000 0000 0000 0000 0000 0000 0000 0000 0000 0000 0000 0000 0000 0000 0000 0000 0000 0000
0000 0000 0000 0000 0000 0000 0000 0000 0000 0000 0000 0000 0000 0000 0000 0000 0000 0000 0000 0000 0000 0000 0000 0000 0000
0000 0000 0000 0000 0000 0000 0000 0000 0000 0000 0000 0000 0000 0000 0000 0000 0000 0000 0000 0000 0000 0000 0000 0000 0000
0000 0000 0000 0000 0000 0000 0000 0000 0000 0000 0000 0000 0000 0000 0000 0000 0000 0000 0000 0000 0000 0000 0000 0000 0000
0000 0000 0000 0000 0000 0000 0000 0000 0000 0000 0000 0000 0000 0000 0000 0000 0000 0000 0000 0000 0000 0000 0000 0000 0000