15 50
0522 0522 0522 0522 0522 0522 0522 0522 0522 0522 0522 0522 0522 0522 0522
0522 0522 0522 0522 0522 0522 0522 0522 0522 0522 0522 0522 0522 0522 0522
0522 0522 0522 0522 0522 0522 0522 0522 0522 0522 0522 0522 0522 0522 0522
0522 0522 0522 0522 0522 0522 0522 0522 0522 0522 0522 0522 0522 0522 0522
0522 0522 0522 0522 0522 0522 0522 0522 0522 0522 0522 0522 0522 0522 0522
0522 0522 0522 0522 0522 0522 0522 0522 0522 0522 0522 0522 0522 0522 0522
0522 0522 0522 0522 0522 0522 0522 0522 0522 0522 0522 0522 0522 0522 0522
0522 0522 0522 0522 0522 0522 0522 0522 0522 0522 0522 0522 0522 0522 0522
0522 0522 0522 0522 0522 0522 0522 0522 0522 0522 0522 0522 0522 0522 0522
0522 0522 0522 0522 0522 0522 0522 0522 0522 0522 0522 0522 0522 0522 0522
0522 0522 0522 0522 0522 0522 0522 0522 0522 0522 0522 0522 0522 0522 0522
0522 0522 0522 0522 0522 0522 0522 0522 0522 0522 0522 0522 0522 0522 0522
0522 0522 0522 0522 0522 0522 0522 0522 0522 0522 0522 0522 0522 0522 0522
0522 0522 0522 0522 0522 0522 0522 0522 0522 0522 0522 0522 0522 0522 0522
0522 0522 0522 0522 0522 0522 0522 0522 0522 0522 0522 0522 0522 0522 0522
0522 0522 0522 0522 0522 0522 0522 0522 0522 0522 0522 0522 0522 0522 0522
0522 0522 0522 0522 0522 0522 0522 0522 0522 0522 0522 0522 0522 0522 0522
0522 0522 0522 0522 0522 0522 0522 0522 0522 0522 0522 0522 0522 0522 0522
0522 0522 0522 0522 0522 0522 0522 0522 0522 0522 0522 0522 0522 0522 0522
0522 0522 0522 0522 0522 0522 0522 0522 0522 0522 0522 0522 0522 0522 0522
0522 0522 0522 0522 0522 0522 0522 0522 0522 0522 0522 0522 0522 0522 0522
0522 0522 0522 0522 0522 0522 0522 0522 0522 0522 0522 0522 0522 0522 0522
0522 0522 0522 0522 0522 0522 0522 0522 0522 0522 0522 0522 0522 0522 0522
0522 0522 0522 0522 0522 0522 0522 0522 0522 0522 0522 0522 0522 0522 0522
0522 0522 0522 0522 0522 0522 0522 0522 0522 0522 0522 0522 0522 0522 0522
0522 0522 0522 0522 0522 0522 0522 0522 0522 0522 0522 0522 0522 0522 0522
0522 0522 0522 0522 0522 0522 0522 0522 0522 0522 0522 0522 0522 0522 0522
0522 0522 0522 0522 0522 0522 0522 0522 0522 0522 0522 0522 0522 0522 0522
0522 0522 0522 0522 0522 0522 0522 0522 0522 0522 0522 0522 0522 0522 0522
0522 0522 0522 0522 0522 0522 0522 0522 0522 0522 0522 0522 0522 0522 0522
0522 0522 0522 0522 0522 0522 0522 0522 0522 0522 0522 0522 0522 0522 0522
0522 0522 0522 0522 0522 0522 0522 0522 0522 0522 0522 0522 0522 0522 0522
0522 0522 0522 0522 0522 0522 0522 0522 0522 0522 0522 0522 0522 0522 0522
0522 0522 0522 0522 0522 0522 0522 0522 0522 0522 0522 0522 0522 0522 0522
0522 0522 0522 0522 0522 0522 0522 0522 0522 0522 0522 0522 0522 0522 0522
0522 0522 0522 0522 0522 0522 0522 0522 0522 0522 0522 0522 0522 0522 0522
0522 0522 0522 0522 0522 0522 0522 0522 0522 0522 0522 0522 0522 0522 0522
0522 0522 0522 0522 0522 0522 0522 0522 0522 0522 0522 0522 0522 0522 0522
0522 0522 0522 0522 0522 0522 0522 0522 0522 0522 0522 0522 0522 0522 0522
0522 0522 0522 0522 0522 0522 0522 0522 0522 0522 0522 0522 0522 0522 0522
0522 0522 0522 0522 0522 0522 0522 0522 0522 0522 0522 0522 0522 0522 0522
0522 0522 0522 0522 0522 0522 0522 0522 0522 0522 0522 0522 0522 0522 0522
0522 0522 0522 0522 0522 0522 0522 0522 0522 0522 0522 0522 0522 0522 0522
0522 0522 0522 0522 0522 0522 0522 0522 0522 0522 0522 0522 0522 0522 0522
0522 0522 0522 0522 0522 0522 0522 0522 0522 0522 0522 0522 0522 0522 0522
0522 0522 0522 0522 0522 0522 0522 0522 0522 0522 0522 0522 0522 0522 0522
0522 0522 0522 0522 0522 0522 0522 0522 0522 0522 0522 0522 0522 0522 0522
0522 0522 0522 0522 0522 0522 0522 0522 0522 0522 0522 0522 0522 0522 0522
0522 0522 0522 0522 0522 0522 0522 0522 0522 0522 0522 0522 0522 0522 0522
0522 0522 0522 0522 0522 0522 0522 0522 0522 0522 0522 0522 0522 0522 0522
-----
0000 0000 0000 0000 7202 0000 4504 4505 4506 0000 7720 7722 0000 0000 0000
0000 0000 0000 0000 0000 0000 4568 4569 4570 0000 7848 7850 0000 0000 0000
0000 0000 0000 0000 0000 0000 4568 4569 4570 0000 0000 0000 0000 0000 0000
0000 0000 0000 0000 0000 0000 4568 4569 4570 0000 0000 0000 0000 0000 0000
0000 0000 0000 0000 0000 0000 4568 4569 4570 0000 0000 0000 0000 0000 0000
0000 0000 0000 0000 0000 0000 4568 4569 4570 0000 0000 0000 0000 0000 0000
0000 0000 0000 0000 0000 0000 4568 4569 4570 0000 0000 0000 0000 0000 0000
0000 0000 0000 0000 0000 0000 4632 4633 4634 0000 0000 0000 0000 0000 0000
1026 1026 1026 1026 1026 1026 0024 0026 0028 1026 1026 1026 1026 1026 1026
1026 1026 1026 1026 1026 1026 0024 0026 0028 1026 1026 1026 1026 1026 1026
1026 1026 1026 1026 1026 1026 0024 0026 0028 1026 1026 1026 1026 1026 1026
0000 0000 0000 0000 0000 0000 4504 4505 4506 0000 0000 0000 0000 0000 0000
0000 0000 0000 0000 0000 0000 4568 4569 4570 0000 0000 0000 0000 0000 0000
0000 0000 0000 0000 0000 0000 4568 4569 4570 0000 0000 0000 0000 0000 0000
0000 0000 0000 0000 0000 0000 4568 4569 4570 0000 0000 0000 0000 0000 0000
0000 0000 0000 0000 0000 0000 4568 4569 4570 0000 0000 0000 0000 0000 0000
0000 0000 0000 0000 0000 0000 4568 4569 4570 0000 0000 0000 0000 0000 0000
0000 0000 0000 0000 0000 0000 4568 4569 4570 0000 0000 0000 0000 0000 0000
0000 0000 0000 0000 0000 0000 4568 4569 4570 0000 0000 0000 0000 0000 0000
0000 0000 0000 0000 0000 0000 4568 4569 4570 0000 0000 0000 0000 0000 0000
0000 0000 0000 0000 0000 0000 4568 4569 4570 0000 0000 0000 0000 0000 0000
0000 0000 0000 0000 0000 0000 4568 4569 4570 0000 0000 0000 0000 0000 0000
1026 1026 1026 1026 1026 1026 0024 0026 0028 1026 1026 1026 1026 1026 1026
1026 1026 1026 1026 1026 1026 0024 0026 0028 1026 1026 1026 1026 1026 1026
1026 1026 1026 1026 1026 1026 0024 0026 0028 1026 1026 1026 1026 1026 1026
0000 0000 0000 0000 0000 0000 4568 4569 4570 0000 0000 0000 0000 0000 0000
0000 0000 0000 0000 0000 0000 4568 4569 4570 0000 0000 0000 0000 0000 0000
0000 0000 0000 0000 0000 0000 4568 4569 4570 0000 0000 0000 0000 0000 0000
0000 0000 0000 0000 0000 0000 4568 4569 4570 0000 0000 0000 0000 0000 0000
0000 0000 0000 0000 0000 0000 4568 4569 4570 0000 0000 0000 0000 0000 0000
0000 0000 0000 0000 0000 0000 4568 4569 4570 0000 0000 0000 0000 0000 0000
0000 0000 0000 0000 0000 0000 4568 4569 4570 0000 0000 0000 0000 0000 0000
0000 0000 0000 0000 0000 0000 4568 4569 4570 0000 0000 0000 0000 0000 0000
0000 0000 0000 0000 0000 0000 4568 4569 4570 0000 0000 0000 0000 0000 0000
0000 0000 0000 0000 0000 0000 4568 4569 4570 0000 0000 0000 0000 0000 0000
1026 1026 1026 1026 1026 1026 0024 0026 0028 1026 1026 1026 1026 1026 1026
1026 1026 1026 1026 1026 1026 0024 0026 0028 1026 1026 1026 1026 1026 1026
1026 1026 1026 1026 1026 1026 0024 0026 0028 1026 1026 1026 1026 1026 1026
0000 0000 0000 0000 0000 0000 4568 4569 4570 0000 0000 0000 0000 0000 0000
0000 0000 0000 0000 0000 0000 4568 4569 4570 0000 0000 0000 0000 0000 0000
0000 0000 0000 0000 0000 0000 4568 4569 4570 0000 0000 0000 0000 0000 0000
0000 0000 0000 0000 0000 0000 4568 4569 4570 0000 0000 0000 0000 0000 0000
0000 0000 0000 0000 0000 0000 4568 4569 4570 0000 0000 0000 0000 0000 0000
0000 0000 0000 0000 0000 0000 4568 4569 4570 0000 0000 0000 0000 0000 0000
0000 0000 0000 0000 0000 0000 4568 4569 4570 0000 0000 0000 0000 0000 0000
0000 0000 0000 0000 0000 0000 4568 4569 4570 0000 0000 0000 0000 0000 0000
0000 0000 0000 0000 0000 0000 4568 4569 4570 0000 0000 0000 0000 0000 0000
0000 0000 0000 0000 0000 0000 4568 4569 4570 0000 0000 0000 0000 0000 0000
0000 0000 0000 0000 0000 0000 4568 4569 4570 0000 0000 0000 0000 0000 0000
0000 0000 0000 0000 0000 0000 4632 4633 4634 0000 0000 0000 0000 0000 0000
-----
0000 0000 0000 0000 0000 0000 7212 7214 7216 0000 0000 0000 0000 0000 0000
0000 0000 0000 0000 0000 0000 7340 7342 7344 0000 0000 0000 0000 0000 0000
0000 0000 0000 0000 0000 0000 0000 0000 0000 0000 0000 0000 0000 0000 0000
0000 0000 0000 0000 0000 0000 0000 0000 0000 0000 0000 0000 0000 0000 0000
0000 0000 0000 0000 0000 0000 0000 0000 0000 0000 0000 0000 0000 0000 0000
0000 0000 0000 0000 0000 0000 0000 0000 0000 0000 0000 0000 0000 0000 0000
0000 0000 0000 0000 0000 6942 0000 0000 0000 6942 0000 0000 0000 0000 0000
0000 0000 0000 0000 0000 7070 0000 0000 0000 7070 0000 0000 0000 0000 0000
0000 0000 0000 0000 0000 0000 0000 0000 0000 0000 0000 0000 0000 0000 0000
0000 0000 0000 0000 0000 0000 0000 0000 0000 0000 0000 0000 0000 0000 0000
0000 0000 0000 0000 0000 7230 0000 0000 0000 7230 0000 0000 0000 0000 0000
0000 0000 0000 0000 0000 7358 0000 0000 0000 7358 0000 0000 0000 0000 0000
0000 0000 0000 0000 0000 0000 0000 0000 0000 0000 0000 0000 0000 0000 0000
0000 0000 0000 0000 0000 0000 0000 0000 0000 0000 0000 0000 0000 0000 0000
0000 0000 0000 0000 0000 0000 0000 0000 0000 0000 0000 0000 0000 0000 0000
0000 0000 0000 0000 0000 7472 0000 0000 0000 7472 0000 0000 0000 0000 0000
0000 0000 0000 0000 0000 7600 0000 0000 0000 7600 0000 0000 0000 0000 0000
0000 0000 0000 0000 0000 0000 0000 0000 0000 0000 0000 0000 0000 0000 0000
0000 0000 0000 0000 0000 0000 0000 0000 0000 0000 0000 0000 0000 0000 0000
0000 0000 0000 0000 0000 0000 0000 0000 0000 0000 0000 0000 0000 0000 0000
0000 0000 0000 0000 0000 7472 0000 0000 0000 7472 0000 0000 0000 0000 0000
0000 0000 0000 0000 0000 7600 0000 0000 0000 7600 0000 0000 0000 0000 0000
0000 0000 0000 0000 0000 0000 0000 0000 0000 0000 0000 0000 0000 0000 0000
0000 0000 0000 0000 0000 0000 0000 0000 0000 0000 0000 0000 0000 0000 0000
0000 0000 0000 0000 0000 7474 0000 0000 0000 7476 0000 0000 0000 0000 0000
0000 0000 0000 0000 0000 7602 0000 0000 0000 7604 0000 0000 0000 0000 0000
0000 0000 0000 0000 0000 0000 0000 0000 0000 0000 0000 0000 0000 0000 0000
0000 0000 0000 0000 0000 0000 0000 0000 0000 0000 0000 0000 0000 0000 0000
0000 0000 0000 0000 0000 0000 0000 0000 0000 0000 0000 0000 0000 0000 0000
0000 0000 0000 0000 0000 7474 0000 0000 0000 7476 0000 0000 0000 0000 0000
0000 0000 0000 0000 0000 7602 0000 0000 0000 7604 0000 0000 0000 0000 0000
0000 0000 0000 0000 0000 0000 0000 0000 0000 0000 0000 0000 0000 0000 0000
0000 0000 0000 0000 0000 0000 0000 0000 0000 0000 0000 0000 0000 0000 0000
0000 0000 0000 0000 0000 7474 0000 0000 0000 7476 0000 0000 0000 0000 0000
0000 0000 0000 0000 0000 7602 0000 0000 0000 7604 0000 0000 0000 0000 0000
0000 0000 0000 0000 0000 0000 0000 0000 0000 0000 0000 0000 0000 0000 0000
0000 0000 0000 0000 0000 0000 0000 0000 0000 0000 0000 0000 0000 0000 0000
0000 0000 0000 0000 0000 7474 0000 0000 0000 7476 0000 0000 0000 0000 0000
0000 0000 0000 0000 0000 7602 0000 0000 0000 7604 0000 0000 0000 0000 0000
0000 0000 0000 0000 0000 0000 0000 0000 0000 0000 0000 0000 0000 0000 0000
0000 0000 0000 0000 0000 0000 0000 0000 0000 0000 0000 0000 0000 0000 0000
0000 0000 0000 0000 0000 0000 0000 0000 0000 0000 0000 0000 0000 0000 0000
0000 0000 0000 0000 0000 0000 0000 0000 0000 0000 0000 0000 0000 0000 0000
0000 0000 0000 0000 0000 0000 0000 0000 0000 0000 0000 0000 0000 0000 0000
0000 0000 0000 0000 0000 7474 0000 0000 0000 7476 0000 0000 0000 0000 0000
0000 0000 0000 0000 0000 7602 0000 0000 0000 7604 0000 0000 0000 0000 0000
0000 0000 0000 0000 0000 0000 0000 0000 0000 0000 0000 0000 0000 0000 0000
0000 0000 0000 0000 0000 0000 0000 0000 0000 0000 0000 0000 0000 0000 0000
0000 0000 0000 0000 0000 0000 0000 0000 0000 0000 0000 0000 0000 0000 0000
0000 0000 0000 0000 0000 0000 0000 0000 0000 0000 0000 0000 0000 0000 0000