32 25
0016 0016 0016 0016 0016 0016 0016 0016 0016 0016 0016 0016 0016 0016 0016 0016 0016 0016 0016 0016 0016 0016 0016 0016 0016 0016 0016 0016 0016 0016 0016 0016
2048 2049 2049 2049 2049 2049 2049 2049 2049 2049 2049 2049 2049 2049 2049 2050 2048 2049 2049 2049 2049 2049 2049 2049 2049 2049 2049 2049 2049 2049 2049 2050
2112 2113 2113 2113 2113 2113 2113 2113 2113 2113 2113 2113 2113 2113 2113 2114 2048 2049 2049 2049 2049 2049 2049 2049 2049 2049 2049 2049 2049 2049 2049 2050
2112 2113 2113 2113 2113 2113 2113 2113 2113 2113 2113 2113 2113 2113 2113 2114 2048 2049 2049 2049 2049 2049 2049 2049 2049 2049 2049 2049 2049 2049 2049 2050
2112 2113 2113 2113 2113 2113 2113 2113 2113 2113 2113 2113 2113 2113 2113 2114 2048 2049 2049 2049 2049 2049 2049 2049 2049 2049 2049 2049 2049 2049 2049 2050
2112 2113 2113 2113 2113 2113 2113 2113 2113 2113 2113 2113 2113 2113 2113 2114 2048 2049 2049 2049 2049 2049 2049 2049 2049 2049 2049 2049 2049 2049 2049 2050
2112 2113 2113 2113 2113 2113 2113 2113 2113 2113 2113 2113 2113 2113 2113 2114 2048 2049 2049 2049 2049 2049 2049 2049 2049 2049 2049 2049 2049 2049 2049 2050
2112 2113 2113 2113 2113 2113 2113 2113 2113 2113 2113 2113 2113 2113 2113 2114 2048 2049 2049 2049 2049 2049 2049 2049 2049 2049 2049 2049 2049 2049 2049 2050
2176 2177 2177 2177 2177 2177 2177 2177 2177 2177 2177 2177 2177 2177 2177 2178 2048 2049 2049 2049 2049 2049 2049 2049 2049 2049 2049 2049 2049 2049 2049 2050
2048 2049 2049 2049 2049 2049 2049 2049 2049 2049 2049 2049 2049 2049 2049 2050 2048 2049 2049 2049 2049 2049 2049 2049 2049 2049 2049 2049 2049 2049 2049 2050
2112 2113 2113 2113 2113 2113 2113 2113 2113 2113 2113 2113 2113 2113 2113 2114 2048 2049 2049 2049 2049 2049 2049 2049 2049 2049 2049 2049 2049 2049 2049 2050
2112 2113 2113 2113 2113 2113 2113 2113 2113 2113 2113 2113 2113 2113 2113 2114 2048 2049 2049 2049 2049 2049 2049 2049 2049 2049 2049 2049 2049 2049 2049 2050
2112 2113 2113 2113 2113 2113 2113 2113 2113 2113 2113 2113 2113 2113 2113 2114 2048 2049 2049 2049 2049 2049 2049 2049 2049 2049 2049 2049 2049 2049 2049 2050
2112 2113 2113 2113 2113 2113 2113 2113 2113 2113 2113 2113 2113 2113 2113 2114 2048 2049 2049 2049 2049 2049 2049 2049 2049 2049 2049 2049 2049 2049 2049 2050
2112 2113 2113 2113 2113 2113 2113 2113 2113 2113 2113 2113 2113 2113 2113 2114 2048 2049 2049 2049 2049 2049 2049 2049 2049 2049 2049 2049 2049 2049 2049 2050
2112 2113 2113 2113 2113 2113 2113 2113 2113 2113 2113 2113 2113 2113 2113 2114 2048 2049 2049 2049 2049 2049 2049 2049 2049 2049 2049 2049 2049 2049 2049 2050
2176 2177 2177 2177 2177 2177 2177 2177 2177 2177 2177 2177 2177 2177 2177 2178 2048 2049 2049 2049 2049 2049 2049 2049 2049 2049 2049 2049 2049 2049 2049 2050
2048 2049 2049 2049 2049 2049 2049 2049 2049 2049 2049 2049 2049 2049 2049 2050 2048 2049 2049 2049 2049 2049 2049 2049 2049 2049 2049 2049 2049 2049 2049 2050
2112 2113 2113 2113 2113 2113 2113 2113 2113 2113 2113 2113 2113 2113 2113 2114 2048 2049 2049 2049 2049 2049 2049 2049 2049 2049 2049 2049 2049 2049 2049 2050
2112 2113 2113 2113 2113 2113 2113 2113 2113 2113 2113 2113 2113 2113 2113 2114 2048 2049 2049 2049 2049 2049 2049 2049 2049 2049 2049 2049 2049 2049 2049 2050
2112 2113 2113 2113 2113 2113 2113 2113 2113 2113 2113 2113 2113 2113 2113 2114 2048 2049 2049 2049 2049 2049 2049 2049 2049 2049 2049 2049 2049 2049 2049 2050
2112 2113 2113 2113 2113 2113 2113 2113 2113 2113 2113 2113 2113 2113 2113 2114 2048 2049 2049 2049 2049 2049 2049 2049 2049 2049 2049 2049 2049 2049 2049 2050
2112 2113 2113 2113 2113 2113 2113 2113 2113 2113 2113 2113 2113 2113 2113 2114 2048 2049 2049 2049 2049 2049 2049 2049 2049 2049 2049 2049 2049 2049 2049 2050
2112 2113 2113 2113 2113 2113 2113 2113 2113 2113 2113 2113 2113 2113 2113 2114 2048 2049 2049 2049 2049 2049 2049 2049 2049 2049 2049 2049 2049 2049 2049 2050
2176 2177 2177 2177 2177 2177 2177 2177 2177 2177 2177 2177 2177 2177 2177 2178 2048 2049 2049 2049 2049 2049 2049 2049 2049 2049 2049 2049 2049 2049 2049 2050
-----
0000 0000 0000 0000 0000 0000 0000 0000 0000 0000 0000 0000 0000 0000 4106 0000 4106 0000 0000 0000 0000 0000 0000 0000 0000 0000 0000 0000 0000 0000 0000 0000
0000 0000 0000 0000 0000 0000 0000 0000 0000 0000 0000 0000 0000 0000 4108 0000 4108 0000 0000 4500 4501 4502 0000 0000 0000 0000 0000 0000 0000 0000 0000 0000
0000 0000 0000 4500 4501 4502 0000 0000 0000 0000 0000 0000 0000 0000 4234 0000 4234 0000 0000 4500 4501 4502 0000 0000 0000 0000 0000 0000 0000 0000 0000 0000
0000 0000 0000 4564 4565 4566 0000 0000 0000 0000 0000 0000 0000 0000 0000 0000 0000 0000 0000 4500 4501 4502 0000 0000 0000 0000 0000 0000 0000 0000 0000 0000
0000 0000 0000 4628 4629 4630 0000 0000 0000 0000 0000 0000 0000 0000 0000 0000 0000 0000 0000 4500 4501 4502 0000 0000 0000 0000 0000 0000 0000 0000 0000 0000
0000 0000 0000 0000 0000 0000 0000 0000 0000 0000 0000 0000 0000 0000 0000 0000 0000 0000 0000 4500 4501 4502 0000 0000 0000 0000 0000 0000 0000 0000 0000 0000
0000 0000 0000 4106 4106 4106 0000 0000 0000 0000 0000 0000 0000 0000 0000 0000 0000 0000 0000 4500 4501 4502 0000 0000 0000 0000 0000 0000 0000 0000 0000 0000
0000 0000 0000 4234 4234 4234 0000 0000 0000 0000 0000 0000 0000 0000 0000 0000 0000 0000 0000 4500 4501 4502 0000 0000 0000 0000 0000 0000 0000 0000 0000 0000
0000 0000 0000 0000 0000 0000 0000 0000 0000 0000 0000 0000 0000 0000 0000 0000 0000 0000 0000 4500 4501 4502 0000 0000 0000 0000 0000 0000 0000 0000 0000 0000
0000 0000 0000 0000 0000 0000 0000 0000 0000 0000 0000 0000 0000 0000 0000 0000 0000 0000 0000 4500 4501 4502 0000 0000 0000 0000 0000 0000 0000 0000 0000 0000
0000 0000 0000 4500 4501 4502 0000 0000 0000 0000 0000 0000 0000 0000 0000 0000 0000 0000 0000 4500 4501 4502 0000 0000 0000 0000 0000 0000 0000 0000 0000 0000
0000 0000 0000 4564 4565 4566 0000 0000 0000 0000 0000 0000 0000 0000 0000 0000 0000 0000 0000 4500 4501 4502 0000 0000 0000 0000 0000 0000 0000 0000 0000 0000
0000 0000 0000 4628 4629 4630 0000 0000 0000 0000 0000 0000 0000 0000 0000 0000 0000 0000 0000 4500 4501 4502 0000 0000 0000 0000 0000 0000 0000 0000 0000 0000
0000 0000 0000 0000 0000 0000 0000 0000 0000 0000 0000 0000 0000 0000 0000 0000 0000 0000 0000 4500 4501 4502 0000 0000 0000 0000 0000 0000 0000 0000 0000 0000
0000 0000 0000 0000 0000 0000 0000 0000 0000 0000 0000 0000 0000 0000 0000 0000 0000 0000 0000 4500 4501 4502 0000 0000 0000 0000 0000 0000 0000 0000 0000 0000
0000 0000 0000 0000 0000 0000 0000 0000 0000 0000 0000 0000 0000 0000 0000 0000 0000 0000 0000 4500 4501 4502 0000 0000 0000 0000 0000 0000 0000 0000 0000 0000
0000 0000 0000 0000 0000 0000 0000 0000 0000 0000 0000 0000 0000 0000 0000 0000 0000 0000 0000 4500 4501 4502 0000 0000 0000 0000 0000 0000 0000 0000 0000 0000
0000 0000 0000 0000 0000 0000 0000 0000 0000 0000 0000 0000 0000 0000 0000 0000 0000 0000 0000 4500 4501 4502 0000 0000 0000 0000 0000 0000 0000 0000 0000 0000
0000 0000 0000 4500 4501 4502 0000 0000 0000 0000 0000 0000 0000 0000 0000 0000 0000 0000 0000 4500 4501 4502 0000 0000 0000 0000 0000 0000 0000 0000 0000 0000
0000 0000 0000 4564 4565 4566 0000 0000 0000 0000 0000 0000 0000 0000 0000 0000 0000 0000 0000 4500 4501 4502 0000 0000 0000 0000 0000 0000 0000 0000 0000 0000
0000 0000 0000 4628 4629 4630 0000 0000 0000 0000 0000 0000 0000 0000 0000 0000 0000 0000 0000 4500 4501 4502 0000 0000 0000 0000 0000 0000 0000 0000 0000 0000
0000 0000 0000 0000 0000 0000 0000 0000 0000 0000 0000 0000 0000 0000 0000 0000 0000 0000 0000 4500 4501 4502 0000 0000 0000 0000 0000 0000 0000 0000 0000 0000
0000 0000 0000 0000 0000 0000 0000 0000 0000 0000 0000 0000 0000 0000 0000 0000 0000 0000 0000 4500 4501 4502 0000 0000 0000 0000 0000 0000 0000 0000 0000 0000
0000 0000 0000 0000 0000 0000 0000 0000 0000 0000 0000 0000 0000 0000 4106 0000 4106 0000 0000 4500 4501 4502 0000 0000 0000 0000 0000 0000 0000 0000 0000 0000
0000 0000 0000 0000 0000 0000 0000 0000 0000 0000 0000 0000 0000 0000 4108 0000 4108 0000 0000 4500 4501 4502 0000 0000 0000 0000 0000 0000 0000 0000 0000 0000
-----
0000 0000 0000 0000 0000 0000 0000 0000 0000 0000 0000 0000 0000 0000 0000 0000 0000 0000 0000 0000 0000 0000 0000 0000 0000 0000 0000 0000 0000 0000 0000 0000
0000 0000 0000 0000 0000 0000 0000 0000 0000 0000 0000 0000 0000 0000 0000 0000 0000 0000 0000 0000 6184 0000 0000 0000 0000 0000 0000 0000 0000 0000 0000 0000
0000 0000 0000 0000 0000 0000 0000 0000 0000 0000 0000 0000 0000 0000 0000 0000 0000 0000 0000 0000 6184 0000 0000 0000 0000 0000 0000 0000 0000 0000 0000 0000
0000 0000 0000 0000 6184 0000 0000 0000 0000 0000 0000 0000 0000 0000 0000 0000 0000 0000 0000 0000 6184 0000 0000 0000 0000 0000 0000 0000 0000 0000 0000 0000
0000 0000 0000 0000 0000 0000 0000 0000 0000 0000 0000 0000 0000 0000 0000 0000 0000 0000 0000 0000 6184 0000 0000 0000 0000 0000 0000 0000 0000 0000 0000 0000
0000 0000 0000 0000 0000 0000 0000 0000 0000 0000 0000 0000 0000 0000 0000 0000 0000 0000 0000 0000 6184 0000 0000 0000 0000 0000 0000 0000 0000 0000 0000 0000
0000 0000 0000 0000 0000 0000 0000 0000 0000 0000 0000 0000 0000 0000 0000 0000 0000 0000 0000 0000 6184 0000 0000 0000 0000 0000 0000 0000 0000 0000 0000 0000
0000 0000 0000 0000 0000 0000 0000 0000 0000 0000 0000 0000 0000 0000 0000 0000 0000 0000 0000 0000 6184 0000 0000 0000 0000 0000 0000 0000 0000 0000 0000 0000
0000 0000 0000 0000 0000 0000 0000 0000 0000 0000 0000 0000 0000 0000 0000 0000 0000 0000 0000 0000 6184 0000 0000 0000 0000 0000 0000 0000 0000 0000 0000 0000
0000 0000 0000 0000 0000 0000 0000 0000 0000 0000 0000 0000 0000 0000 0000 0000 0000 0000 0000 0000 6184 0000 0000 0000 0000 0000 0000 0000 0000 0000 0000 0000
0000 0000 0000 0000 0000 0000 0000 0000 0000 0000 0000 0000 0000 0000 0000 0000 0000 0000 0000 0000 6184 0000 0000 0000 0000 0000 0000 0000 0000 0000 0000 0000
0000 0000 0000 0000 6184 0000 0000 0000 0000 0000 0000 0000 0000 0000 0000 0000 0000 0000 0000 0000 6184 0000 0000 0000 0000 0000 0000 0000 0000 0000 0000 0000
0000 0000 0000 0000 0000 0000 0000 0000 0000 0000 0000 0000 0000 0000 0000 0000 0000 0000 0000 0000 6184 0000 0000 0000 0000 0000 0000 0000 0000 0000 0000 0000
0000 0000 0000 0000 0000 0000 0000 0000 0000 0000 0000 0000 0000 0000 0000 0000 0000 0000 0000 0000 6184 0000 0000 0000 0000 0000 0000 0000 0000 0000 0000 0000
0000 0000 0000 0000 0000 0000 0000 0000 0000 0000 0000 0000 0000 0000 0000 0000 0000 0000 0000 0000 6184 0000 0000 0000 0000 0000 0000 0000 0000 0000 0000 0000
0000 0000 0000 0000 0000 0000 0000 0000 0000 0000 0000 0000 0000 0000 0000 0000 0000 0000 0000 0000 6184 0000 0000 0000 0000 0000 0000 0000 0000 0000 0000 0000
0000 0000 0000 0000 0000 0000 0000 0000 0000 0000 0000 0000 0000 0000 0000 0000 0000 0000 0000 0000 6184 0000 0000 0000 0000 0000 0000 0000 0000 0000 0000 0000
0000 0000 0000 0000 0000 0000 0000 0000 0000 0000 0000 0000 0000 0000 0000 0000 0000 0000 0000 0000 6184 0000 0000 0000 0000 0000 0000 0000 0000 0000 0000 0000
0000 0000 0000 0000 0000 0000 0000 0000 0000 0000 0000 0000 0000 0000 0000 0000 0000 0000 0000 0000 6184 0000 0000 0000 0000 0000 0000 0000 0000 0000 0000 0000
0000 0000 0000 0000 6184 0000 0000 0000 0000 0000 0000 0000 0000 0000 0000 0000 0000 0000 0000 0000 6184 0000 0000 0000 0000 0000 0000 0000 0000 0000 0000 0000
0000 0000 0000 0000 0000 0000 0000 0000 0000 0000 0000 0000 0000 0000 0000 0000 0000 0000 0000 0000 6184 0000 0000 0000 0000 0000 0000 0000 0000 0000 0000 0000
0000 0000 0000 0000 0000 0000 0000 0000 0000 0000 0000 0000 0000 0000 0000 0000 0000 0000 0000 0000 6184 0000 0000 0000 0000 0000 0000 0000 0000 0000 0000 0000
0000 0000 0000 0000 0000 0000 0000 0000 0000 0000 0000 0000 0000 0000 0000 0000 0000 0000 0000 0000 6184 0000 0000 0000 0000 0000 0000 0000 0000 0000 0000 0000
0000 0000 0000 0000 0000 0000 0000 0000 0000 0000 0000 0000 0000 0000 0000 0000 0000 0000 0000 0000 6184 0000 0000 0000 0000 0000 0000 0000 0000 0000 0000 0000
0000 0000 0000 0000 0000 0000 0000 0000 0000 0000 0000 0000 0000 0000 0000 0000 0000 0000 0000 0000 6184 0000 0000 0000 0000 0000 0000 0000 0000 0000 0000 0000
