38 16
0016 0016 0016 0016 0016 0016 0016 0016 0016 0016 0016 0016 0016 0016 0016 0016 0016 0016 0016 0016 0016 0016 0016 0016 0016 0016 0016 0016 0016 0016 0016 0016 0016 0016 0016 0016 0016 0016
0278 0278 0278 0278 0278 0278 0278 0278 0278 0278 0278 0278 0278 0278 0278 0278 0278 0278 0278 0278 0278 0278 0278 0278 0278 0278 0278 0278 0278 0278 0278 0278 0278 0278 0278 0278 0278 0278
0278 0278 0278 0278 0278 0278 0278 0278 0278 0278 0278 0278 0278 0278 0278 0278 0278 0278 0278 0278 0278 0278 0278 0278 0278 0278 0278 0278 0278 0278 0278 0278 0278 0278 0278 0278 0278 0278
0278 0278 0278 0278 0278 0278 0278 0278 0278 0278 0278 0278 0278 0278 0278 0278 0278 0278 0278 0278 0278 0278 0278 0278 0278 0278 0278 0278 0278 0278 0278 0278 0278 0278 0278 0278 0278 0278
0278 0278 0278 0278 0278 0278 0278 0278 0278 0278 0278 0278 0278 0278 0278 0278 0278 0278 0278 0278 0278 0278 0278 0278 0278 0278 0278 0278 0278 0278 0278 0278 0278 0278 0278 0278 0278 0278
0278 0278 0278 0278 0278 0278 0278 0278 0278 0278 0278 0278 0278 0278 0278 0278 0278 0278 0278 0278 0278 0278 0278 0278 0278 0278 0278 0278 0278 0278 0278 0278 0278 0278 0278 0278 0278 0278
0278 0278 0278 0278 0278 0278 0278 0278 0278 0278 0278 0278 0278 0278 0278 0278 0278 0278 0278 0278 0278 0278 0278 0278 0278 0278 0278 0278 0278 0278 0278 0278 0278 0278 0278 0278 0278 0278
0278 0278 0278 0278 0278 0278 0278 0278 0278 0278 0278 0278 0278 0278 0278 0278 0278 0278 0278 0278 0278 0278 0278 0278 0278 0278 0278 0278 0278 0278 0278 0278 0278 0278 0278 0278 0278 0278
0278 0278 0278 0278 0278 0278 0278 0278 0278 0278 0278 0278 0278 0278 0278 0278 0278 0278 0278 0278 0278 0278 0278 0278 0278 0278 0278 0278 0278 0278 0278 0278 0278 0278 0278 0278 0278 0278
0278 0278 0278 0278 0278 0278 0278 0278 0278 0278 0278 0278 0278 0278 0278 0278 0278 0278 0278 0278 0278 0278 0278 0278 0278 0278 0278 0278 0278 0278 0278 0278 0278 0278 0278 0278 0278 0278
0278 0278 0278 0278 0278 0278 0278 0278 0278 0278 0278 0278 0278 0278 0278 0278 0278 0278 0278 0278 0278 0278 0278 0278 0278 0278 0278 0278 0278 0278 0278 0278 0278 0278 0278 0278 0278 0278
0278 0278 0278 0278 0278 0278 0278 0278 0278 0278 0278 0278 0278 0278 0278 0278 0278 0278 0278 0278 0278 0278 0278 0278 0278 0278 0278 0278 0278 0278 0278 0278 0278 0278 0278 0278 0278 0278
0278 0278 0278 0278 0278 0278 0278 0278 0278 0278 0278 0278 0278 0278 0278 0278 0278 0278 0278 0278 0278 0278 0278 0278 0278 0278 0278 0278 0278 0278 0278 0278 0278 0278 0278 0278 0278 0278
0278 0278 0278 0278 0278 0278 0278 0278 0278 0278 0278 0278 0278 0278 0278 0278 0278 0278 0278 0278 0278 0278 0278 0278 0278 0278 0278 0278 0278 0278 0278 0278 0278 0278 0278 0278 0278 0278
0278 0278 0278 0278 0278 0278 0278 0278 0278 0278 0278 0278 0278 0278 0278 0278 0278 0278 0278 0278 0278 0278 0278 0278 0278 0278 0278 0278 0278 0278 0278 0278 0278 0278 0278 0278 0278 0278
0278 0278 0278 0278 0278 0278 0278 0278 0278 0278 0278 0278 0278 0278 0278 0278 0278 0278 0278 0278 0278 0278 0278 0278 0278 0278 0278 0278 0278 0278 0278 0278 0278 0278 0278 0278 0278 0278
-----
0000 7590 7590 7590 7590 7590 7590 7590 7590 7590 7590 7590 7590 7590 7590 7590 7590 7590 6678 6680 6682 7590 7590 7590 7590 7590 7590 7590 7590 7590 7590 7590 7590 7590 7590 7590 7590 7590
7718 7718 7718 7718 7718 7718 7718 7718 7718 7718 7718 7718 7718 7718 7718 7718 7718 7718 6806 6808 6810 7718 7718 7718 7718 7718 7718 7718 7718 7718 7718 7718 7718 7718 7718 7718 7718 7718
7718 0000 0000 0000 0000 0000 0000 0000 0000 0000 0000 0000 0000 0000 0000 0000 0000 0000 0000 0000 0000 0000 0000 0000 0000 0000 0000 0000 0000 0000 0000 0000 0000 0000 0000 0000 0000 7718
7718 0000 0000 0000 0000 0000 0000 0000 0000 0000 0000 0000 0000 0000 0000 0000 0000 0000 0000 0000 0000 0000 0000 0000 0000 0000 0000 0000 0000 0000 0000 0000 0000 0000 0000 0000 0000 7718
7718 0000 0000 0000 0000 0000 0000 0000 7050 0000 0000 0000 0000 0000 0000 0000 6416 0000 0000 0000 0000 0000 6416 0000 0000 0000 0000 0000 0000 0000 7050 0000 0000 0000 0000 0000 0000 7718
7718 0000 0000 0000 0000 5132 7050 7050 7050 7050 7050 5132 0000 0000 0000 6416 6544 6416 0000 0000 0000 6416 6544 6416 0000 0000 0000 5132 7050 7050 7050 7050 7050 5132 0000 0000 0000 7718
7718 0000 0000 0000 0000 5260 0000 0000 5132 0000 0000 5260 0000 0000 6416 6544 0000 6544 6416 0000 6416 6544 0000 6544 6416 0000 0000 5260 0000 0000 5132 0000 0000 5260 0000 0000 0000 7718
7718 0000 0000 0000 7050 7050 7050 7050 5260 7050 7050 7050 7050 0000 6544 6416 0000 0000 6544 0000 6544 0000 0000 6416 6544 0000 7050 7050 7050 7050 5260 7050 7050 7050 7050 0000 0000 0000
7718 0000 0000 0000 0000 0000 7050 0000 0000 0000 7050 0000 0000 0000 0000 6544 6416 0000 0000 0000 0000 0000 6416 6544 0000 0000 0000 0000 7050 0000 0000 0000 7050 0000 0000 0000 0000 0000
7718 0000 0000 0000 0000 0000 0000 7050 0000 7050 0000 0000 0000 0000 0000 0000 6544 6416 0000 0000 0000 6416 6544 0000 0000 0000 0000 0000 0000 7050 0000 7050 0000 0000 0000 0000 0000 7718
7718 0000 0000 0000 0000 0000 0000 0000 7050 0000 0000 0000 0000 0000 0000 0000 0000 6544 6416 0000 6416 6544 0000 0000 0000 0000 0000 0000 0000 0000 7050 0000 0000 0000 0000 0000 0000 7718
7718 0000 0000 0000 0000 0000 0000 7050 0000 7050 0000 0000 0000 0000 0000 0000 0000 0000 6544 6416 6544 0000 0000 0000 0000 0000 0000 0000 0000 7050 0000 7050 0000 0000 0000 0000 0000 7718
7718 0000 0000 0000 0000 0000 7050 0000 0000 0000 7050 0000 0000 0000 0000 0000 0000 0000 0000 6544 0000 0000 0000 0000 0000 0000 0000 0000 7050 0000 0000 0000 7050 0000 0000 0000 0000 7718
7718 0000 0000 0000 0000 0000 0000 0000 0000 0000 0000 0000 0000 0000 0000 0000 0000 0000 0000 0000 0000 0000 0000 0000 0000 0000 0000 0000 0000 0000 0000 0000 0000 0000 0000 0000 0000 7718
7718 7590 7590 7590 7590 7590 7590 7590 7590 7590 7590 7590 7590 7590 7590 7590 7590 7590 7590 7590 7590 7590 7590 7590 7590 7590 7590 7590 7590 7590 7590 7590 7590 7590 7590 7590 7590 7718
7718 7718 7718 7718 7718 7718 7718 7718 7718 7718 7718 7718 7718 7718 7718 7718 7718 7718 7718 7718 7718 7718 7718 7718 7718 7718 7718 7718 7718 7718 7718 7718 7718 7718 7718 7718 7718 7718
-----
7590 0000 0000 0000 0000 0000 0000 0000 0000 0000 0000 0000 0000 0000 0000 0000 0000 0000 0000 0000 0000 0000 0000 0000 0000 0000 0000 0000 0000 0000 0000 0000 0000 0000 0000 0000 0000 7590
7590 0000 0000 0000 0000 0000 0000 0000 0000 0000 0000 0000 0000 0000 0000 0000 0000 0000 0000 0000 0000 0000 0000 0000 0000 0000 0000 0000 0000 0000 0000 0000 0000 0000 0000 0000 0000 7590
7590 0000 0000 0000 0000 0000 0000 0000 0000 0000 0000 0000 0000 0000 0000 0000 0000 0000 0000 0000 0000 0000 0000 0000 0000 0000 0000 0000 0000 0000 0000 0000 0000 0000 0000 0000 0000 7590
7590 0000 0000 0000 0000 0000 0000 0000 0000 0000 0000 0000 0000 0000 0000 0000 0000 0000 0000 0000 0000 0000 0000 0000 0000 0000 0000 0000 0000 0000 0000 0000 0000 0000 0000 0000 0000 7590
7590 0000 0000 0000 0000 0000 0000 0000 0000 0000 0000 0000 0000 0000 0000 0000 0000 0000 0000 0000 0000 0000 0000 0000 0000 0000 0000 0000 0000 0000 0000 0000 0000 0000 0000 0000 0000 7590
7590 0000 0000 0000 0000 0000 0000 0000 0000 0000 0000 0000 0000 0000 0000 0000 0000 0000 0000 0000 0000 0000 0000 0000 0000 0000 0000 0000 0000 0000 0000 0000 0000 0000 0000 0000 0000 7590
7590 0000 0000 0000 0000 0000 0000 0000 0000 0000 0000 0000 0000 0000 0000 0000 0000 0000 0000 0000 0000 0000 0000 0000 0000 0000 0000 0000 0000 0000 0000 0000 0000 0000 0000 0000 0000 0000
7590 0000 0000 0000 0000 0000 0000 0000 0000 0000 0000 0000 0000 0000 0000 0000 0000 0000 0000 0000 0000 0000 0000 0000 0000 0000 0000 0000 0000 0000 0000 0000 0000 0000 0000 0000 0000 0000
7590 0000 0000 0000 0000 0000 0000 0000 0000 0000 0000 0000 0000 0000 0000 0000 0000 0000 0000 0000 0000 0000 0000 0000 0000 0000 0000 0000 0000 0000 0000 0000 0000 0000 0000 0000 0000 7590
7590 0000 0000 0000 0000 0000 0000 0000 0000 0000 0000 0000 0000 0000 0000 0000 0000 0000 0000 0000 0000 0000 0000 0000 0000 0000 0000 0000 0000 0000 0000 0000 0000 0000 0000 0000 0000 7590
7590 0000 0000 0000 0000 0000 0000 0000 0000 0000 0000 0000 0000 0000 0000 0000 0000 0000 0000 0000 0000 0000 0000 0000 0000 0000 0000 0000 0000 0000 0000 0000 0000 0000 0000 0000 0000 7590
7590 0000 0000 0000 0000 0000 0000 0000 0000 0000 0000 0000 0000 0000 0000 0000 0000 0000 0000 0000 0000 0000 0000 0000 0000 0000 0000 0000 0000 0000 0000 0000 0000 0000 0000 0000 0000 7590
7590 0000 0000 0000 0000 0000 0000 0000 0000 0000 0000 0000 0000 0000 0000 0000 0000 0000 0000 0000 0000 0000 0000 0000 0000 0000 0000 0000 0000 0000 0000 0000 0000 0000 0000 0000 0000 7590
7590 0000 0000 0000 0000 0000 0000 0000 0000 0000 0000 0000 0000 0000 0000 0000 0000 0000 0000 0000 0000 0000 0000 0000 0000 0000 0000 0000 0000 0000 0000 0000 0000 0000 0000 0000 0000 7590
7590 0000 0000 0000 0000 0000 0000 0000 0000 0000 0000 0000 0000 0000 0000 0000 0000 0000 0000 0000 0000 0000 0000 0000 0000 0000 0000 0000 0000 0000 0000 0000 0000 0000 0000 0000 0000 7590
0000 0000 0000 0000 0000 0000 0000 0000 0000 0000 0000 0000 0000 0000 0000 0000 0000 0000 0000 0000 0000 0000 0000 0000 0000 0000 0000 0000 0000 0000 0000 0000 0000 0000 0000 0000 0000 0000
