50 30
2048 2049 2049 2049 2049 2049 2049 2049 2049 2049 2049 2049 2049 2049 2049 2049 2049 2049 2049 2049 2049 2049 2049 2049 2049 2049 2049 2049 2049 2049 2049 2049 2049 2049 2049 2049 2049 2049 2049 2049 2049 2049 2049 2049 2049 2049 2049 2049 2049 2050
2112 2113 2113 2113 2113 2113 2113 2113 2113 2113 2113 2113 2113 2113 2113 2113 2113 2113 2113 2113 2113 2113 2113 2113 2113 2113 2113 2113 2113 2113 2113 2113 2113 2113 2113 2113 2113 2113 2113 2113 2113 2113 2113 2113 2113 2113 2113 2113 2113 2114
2112 2113 2113 2113 2113 2113 2113 2113 2113 2113 2113 2113 2113 2113 2113 2113 2113 2113 2113 2113 2113 2113 2113 2113 2113 2113 2113 2113 2113 2113 2113 2113 2113 2113 2113 2113 2113 2113 2113 2113 2113 2113 2113 2113 2113 2113 2113 2113 2113 2114
2112 2113 2113 2113 2113 2113 2113 2113 2113 2113 2113 2113 2113 2113 2113 2113 2113 2113 2113 2113 2113 2113 2113 2113 2113 2113 2113 2113 2113 2113 2113 2113 2113 2113 2113 2113 2113 2113 2113 2113 2113 2113 2113 2113 2113 2113 2113 2113 2113 2114
2112 2113 2113 2113 2113 2113 2113 2113 2113 2113 2113 2113 2113 2113 2113 2113 2113 2113 2113 2113 2113 2113 2113 2113 2113 2113 2113 2113 2113 2113 2113 2113 2113 2113 2113 2113 2113 2113 2113 2113 2113 2113 2113 2113 2113 2113 2113 2113 2113 2114
2112 2113 2113 2113 2113 2113 2113 2113 2113 2113 2113 2113 2113 2113 2113 2113 2113 2113 2113 2113 2113 2113 2113 2113 2113 2113 2113 2113 2113 2113 2113 2113 2113 2113 2113 2113 2113 2113 2113 2113 2113 2113 2113 2113 2113 2113 2113 2113 2113 2114
2112 2113 2113 2113 2113 2113 2113 2113 2113 2113 2113 2113 2113 2113 2113 2113 2113 2113 2113 2113 2113 2113 2113 2113 2113 2113 2113 2113 2113 2113 2113 2113 2113 2113 2113 2113 2113 2113 2113 2113 2113 2113 2113 2113 2113 2113 2113 2113 2113 2114
2112 2113 2113 2113 2113 2113 2113 2113 2113 2113 2113 2113 2113 2113 2113 2113 2113 2113 2113 2113 2113 2113 2113 2113 2113 2113 2113 2113 2113 2113 2113 2113 2113 2113 2113 2113 2113 2113 2113 2113 2113 2113 2113 2113 2113 2113 2113 2113 2113 2114
2112 2113 2113 2113 2113 2113 2113 2113 2113 2113 2113 2113 2113 2113 2113 2113 2113 2113 2113 2113 2113 2113 2113 2113 2113 2113 2113 2113 2113 2113 2113 2113 2113 2113 2113 2113 2113 2113 2113 2113 2113 2113 2113 2113 2113 2113 2113 2113 2113 2114
2112 2113 2113 2113 2113 2113 2113 2113 2113 2113 2113 2113 2113 2113 2113 2113 2113 2113 2113 2113 2113 2113 2113 2113 2113 2113 2113 2113 2113 2113 2113 2113 2113 2113 2113 2113 2113 2113 2113 2113 2113 2113 2113 2113 2113 2113 2113 2113 2113 2114
2112 2113 2113 2113 2113 2113 2113 2113 2113 2113 2113 2113 2113 2113 2113 2113 2113 2113 2113 2113 2113 2113 2113 2113 2113 2113 2113 2113 2113 2113 2113 2113 2113 2113 2113 2113 2113 2113 2113 2113 2113 2113 2113 2113 2113 2113 2113 2113 2113 2114
2112 2113 2113 2113 2113 2113 2113 2113 2113 2113 2113 2113 2113 2113 2113 2113 2113 2113 2113 2113 2113 2113 2113 2113 2113 2113 2113 2113 2113 2113 2113 2113 2113 2113 2113 2113 2113 2113 2113 2113 2113 2113 2113 2113 2113 2113 2113 2113 2113 2114
2112 2113 2113 2113 2113 2113 2113 2113 2113 2113 2113 2113 2113 2113 2113 2113 2113 2113 2113 2113 2113 2113 2113 2113 2113 2113 2113 2113 2113 2113 2113 2113 2113 2113 2113 2113 2113 2113 2113 2113 2113 2113 2113 2113 2113 2113 2113 2113 2113 2178
2112 2113 2113 2113 2113 2113 2113 2113 2113 2113 2113 2113 2113 2113 2113 2113 2113 2113 2113 2113 2113 2113 2113 2113 2113 2113 2113 2113 2113 2113 2113 2113 2113 2113 2113 2113 2113 2113 2113 2113 2113 2113 2113 2113 2113 2113 2113 2113 2114 2432
2112 2113 2113 2113 2113 2113 2113 2113 2113 2113 2113 2113 2113 2113 2113 2113 2113 2113 2113 2113 2113 2113 2113 2113 2113 2113 2113 2113 2113 2113 2113 2113 2113 2113 2113 2113 2113 2113 2113 2113 2113 2113 2113 2113 2113 2113 2113 2113 2114 2560
2112 2113 2113 2113 2113 2113 2113 2113 2113 2113 2113 2113 2113 2113 2113 2113 2113 2113 2113 2113 2113 2113 2113 2113 2113 2113 2113 2113 2113 2113 2113 2113 2113 2113 2113 2113 2113 2113 2113 2113 2113 2113 2113 2113 2113 2113 2113 2113 2113 2050
2112 2113 2113 2113 2113 2113 2113 2113 2113 2113 2113 2113 2113 2113 2113 2113 2113 2113 2113 2113 2113 2113 2113 2113 2113 2113 2113 2113 2113 2113 2113 2113 2113 2113 2113 2113 2113 2113 2113 2113 2113 2113 2113 2113 2113 2113 2113 2113 2113 2114
2112 2113 2113 2113 2113 2113 2113 2113 2113 2113 2113 2113 2113 2113 2113 2113 2113 2113 2113 2113 2113 2113 2113 2113 2113 2113 2113 2113 2113 2113 2113 2113 2113 2113 2113 2113 2113 2113 2113 2113 2113 2113 2113 2113 2113 2113 2113 2113 2113 2114
2112 2113 2113 2113 2113 2113 2113 2113 2113 2113 2113 2113 2113 2113 2113 2113 2113 2113 2113 2113 2113 2113 2113 2113 2113 2113 2113 2113 2113 2113 2113 2113 2113 2113 2113 2113 2113 2113 2113 2113 2113 2113 2113 2113 2113 2113 2113 2113 2113 2114
2112 2113 2113 2113 2113 2113 2113 2113 2113 2113 2113 2113 2113 2113 2113 2113 2113 2113 2113 2113 2113 2113 2113 2113 2113 2113 2113 2113 2113 2113 2113 2113 2113 2113 2113 2113 2113 2113 2113 2113 2113 2113 2113 2113 2113 2113 2113 2113 2113 2114
2112 2113 2113 2113 2113 2113 2113 2113 2113 2113 2113 2113 2113 2113 2113 2113 2113 2113 2113 2113 2113 2113 2113 2113 2113 2113 2113 2113 2113 2113 2113 2113 2113 2113 2113 2113 2113 2113 2113 2113 2113 2113 2113 2113 2113 2113 2113 2113 2113 2114
2112 2113 2113 2113 2113 2113 2113 2113 2113 2113 2113 2113 2113 2113 2113 2113 2113 2113 2113 2113 2113 2113 2113 2113 2113 2113 2113 2113 2113 2113 2113 2113 2113 2113 2113 2113 2113 2113 2113 2113 2113 2113 2113 2113 2113 2113 2113 2113 2113 2114
2112 2113 2113 2113 2113 2113 2113 2113 2113 2113 2113 2113 2113 2113 2113 2113 2113 2113 2113 2113 2113 2113 2113 2113 2113 2113 2113 2113 2113 2113 2113 2113 2113 2113 2113 2113 2113 2113 2113 2113 2113 2113 2113 2113 2113 2113 2113 2113 2113 2114
2112 2113 2113 2113 2113 2113 2113 2113 2113 2113 2113 2113 2113 2113 2113 2113 2113 2113 2113 2113 2113 2113 2113 2113 2113 2113 2113 2113 2113 2113 2113 2113 2113 2113 2113 2113 2113 2113 2113 2113 2113 2113 2113 2113 2113 2113 2113 2113 2113 2114
2112 2113 2113 2113 2113 2113 2113 2113 2113 2113 2113 2113 2113 2113 2113 2113 2113 2113 2113 2113 2113 2113 2113 2113 2113 2113 2113 2113 2113 2113 2113 2113 2113 2113 2113 2113 2113 2113 2113 2113 2113 2113 2113 2113 2113 2113 2113 2113 2113 2114
2112 2113 2113 2113 2113 2113 2113 2113 2113 2113 2113 2113 2113 2113 2113 2113 2113 2113 2113 2113 2113 2113 2113 2113 2113 2113 2113 2113 2113 2113 2113 2113 2113 2113 2113 2113 2113 2113 2113 2113 2113 2113 2113 2113 2113 2113 2113 2113 2113 2114
2112 2113 2113 2113 2113 2113 2113 2113 2113 2113 2113 2113 2113 2113 2113 2113 2113 2113 2113 2113 2113 2113 2113 2113 2113 2113 2113 2113 2113 2113 2113 2113 2113 2113 2113 2113 2113 2113 2113 2113 2113 2113 2113 2113 2113 2113 2113 2113 2113 2114
2112 2113 2113 2113 2113 2113 2113 2113 2113 2113 2113 2113 2113 2113 2113 2113 2113 2113 2113 2113 2113 2113 2113 2113 2113 2113 2113 2113 2113 2113 2113 2113 2113 2113 2113 2113 2113 2113 2113 2113 2113 2113 2113 2113 2113 2113 2113 2113 2113 2114
2112 2113 2113 2113 2113 2113 2113 2113 2113 2113 2113 2113 2113 2113 2113 2113 2113 2113 2113 2113 2113 2113 2113 2113 2113 2113 2113 2113 2113 2113 2113 2113 2113 2113 2113 2113 2113 2113 2113 2113 2113 2113 2113 2113 2113 2113 2113 2113 2113 2114
2176 2177 2177 2177 2177 2177 2177 2177 2177 2177 2177 2177 2177 2177 2177 2177 2177 2177 2177 2177 2177 2177 2177 2177 2177 2177 2177 2177 2177 2177 2177 2177 2177 2177 2177 2177 2177 2177 2177 2177 2177 2177 2177 2177 2177 2177 2177 2177 2177 2178
-----
4106 4106 4106 4106 4106 4106 4106 4106 4106 4106 4106 4106 4106 4106 4106 4106 4106 4106 4106 4106 4106 4106 4106 4106 4106 4106 4106 4106 4106 4106 4106 4106 4106 4106 4106 4106 4106 4106 4106 4106 4106 4106 4106 4106 4106 4106 4106 4106 4106 4106
4108 4234 4234 4234 4234 4234 4234 4234 4234 4234 4234 4234 4234 4234 4234 4234 4234 4234 4234 4234 4234 4234 4234 4234 4234 4234 4234 4234 4234 4234 4234 4234 4234 4234 4234 4234 4234 4234 4234 4234 4234 4234 4234 4234 4234 4234 4234 4234 4234 4108
4108 0000 0000 0000 0000 0000 0000 0000 0000 0000 0000 0000 0000 0000 0000 0000 0000 0000 0000 0000 0000 0000 0000 0000 0000 0000 0000 0000 0000 0000 0000 0000 0000 0000 0000 0000 0000 0000 0000 0000 0000 0000 0000 0000 0000 0000 0000 0000 0000 4108
4108 0000 0000 0000 0000 0000 0000 0000 0000 0000 0000 0000 0000 0000 0000 0000 0000 0000 0000 0000 2608 2609 2609 2609 2609 2609 2609 2609 2609 2609 2609 2609 2610 0000 0000 0000 0000 0000 0000 0000 0000 0000 0000 0000 0000 0000 0000 0000 0000 4108
4108 0000 0000 0000 0000 0000 0000 0000 0000 0000 0000 0000 0000 0000 0000 0000 0000 0000 0000 0000 2672 2673 2673 2673 2673 2673 2673 2673 2673 2673 2673 2673 2674 0000 0000 0000 0000 0000 0000 0000 0000 0000 0000 0000 0000 0000 0000 0000 0000 4108
4108 0000 0000 0000 0000 0000 0000 0000 0000 0000 0000 0000 0000 0000 0000 0000 0000 0000 0000 0000 2736 2737 2737 2737 2737 2737 2737 2737 2737 2737 2737 2737 2738 0000 0000 0000 0000 0000 0000 0000 0000 0000 0000 0000 0000 0000 0000 0000 0000 4108
4108 0000 0000 0000 0000 0000 0000 0000 0000 0000 0000 0000 0000 0000 0000 0000 0000 0000 0000 0000 2864 2865 2865 2865 2865 2865 2865 2865 2865 2865 2865 2865 2866 0000 0000 0000 0000 0000 0000 0000 0000 0000 0000 0000 0000 0000 0000 0000 0000 4108
4108 0000 0000 0000 0000 0000 0000 0000 0000 0000 0000 0000 0000 0000 0000 0000 0000 0000 0000 0000 2928 2929 2929 2929 2929 2929 2929 2929 2929 2929 2929 2929 2930 0000 0000 0000 0000 0000 0000 0000 0000 0000 0000 0000 0000 0000 0000 0000 0000 4108
4108 0000 0000 0000 0000 0000 0000 0000 0000 0000 0000 0000 0000 0000 0000 0000 0000 0000 0000 0000 2928 2929 2929 2929 2929 2929 2929 2929 2929 2929 2929 2929 2930 0000 0000 0000 0000 0000 0000 0000 0000 0000 0000 0000 0000 0000 0000 0000 0000 4108
4108 0000 0000 0000 0000 0000 0000 0000 0000 0000 0000 0000 0000 0000 0000 0000 0000 0000 0000 0000 2928 2929 2929 2929 2929 2929 2929 2929 2929 2929 2929 2929 2930 0000 0000 0000 0000 0000 0000 0000 0000 0000 0000 0000 0000 0000 0000 0000 0000 4108
4108 0000 0000 0000 0000 0000 0000 0000 0000 0000 0000 0000 0000 0000 0000 0000 0000 0000 0000 0000 2992 2993 2993 2993 2993 2993 2993 2993 2993 2993 2993 2993 2994 0000 0000 0000 0000 0000 0000 0000 0000 0000 0000 0000 0000 0000 0000 0000 0000 4108
4108 0000 0000 0000 0000 0000 0000 0000 0000 0000 0000 0000 0000 0000 0000 0000 0000 0000 0000 0000 0000 0000 0000 0000 0000 0000 0000 0000 0000 0000 0000 0000 0000 0000 0000 0000 0000 0000 0000 0000 0000 0000 0000 0000 0000 0000 0000 0000 4106 4108
4108 0000 0000 0000 0000 0000 0000 0000 0000 0000 0000 0000 0000 0000 0000 0000 0000 0000 0000 0000 0000 0000 0000 0000 0000 0000 0000 0000 0000 0000 0000 0000 0000 0000 0000 0000 0000 0000 0000 0000 0000 0000 0000 0000 0000 0000 0000 0000 4234 4234
4108 0000 0000 0000 0000 0000 0000 0000 3104 3105 3105 3105 3105 3105 3106 0000 0000 0000 0000 0000 0000 0000 0000 0000 0000 0000 0000 0000 0000 0000 0000 0000 0000 0000 0000 0000 0000 0000 0000 0000 0000 0000 0000 0000 0000 0000 0000 0000 0000 0000
4108 0000 0000 0000 0000 0000 0000 0000 3232 3233 3233 3233 3233 3233 3234 0000 0000 0000 0000 0000 0000 0000 0000 0000 0000 0000 0000 0000 0000 0000 0000 0000 0000 0000 0000 0000 0000 0000 0000 0000 0000 0000 0000 0000 0000 0000 0000 0000 0000 0000
4108 0000 0000 0000 0000 0000 0000 0000 3360 3361 3361 3361 3361 3361 3362 0000 0000 0000 0000 0000 0000 0000 0000 0000 0000 0000 0000 0000 0000 0000 0000 0000 0000 0000 0000 0000 0000 0000 0000 0000 0000 0000 0000 0000 0000 0000 0000 0000 4106 4106
4108 0000 0000 0000 0000 0000 0000 0000 3488 3489 3489 3489 3489 3489 3490 0000 0000 0000 0000 0000 0000 0000 0000 0000 0000 0000 0000 0000 0000 0000 0000 0000 0000 0000 0000 0000 0000 0000 0000 0000 0000 0000 0000 0000 0000 0000 0000 0000 4234 4108
4108 0000 0000 0000 0000 0000 0000 0000 0000 0000 0000 0000 0000 0000 0000 0000 0000 0000 0000 0000 0000 0000 0000 0000 0000 0000 0000 0000 0000 0000 0000 0000 0000 0000 0000 0000 0000 0000 0000 0000 0000 0000 0000 0000 0000 0000 0000 0000 0000 4108
4108 0000 0000 0000 0000 0000 0000 0000 0000 0000 0000 0000 0000 0000 0000 0000 0000 0000 0000 0000 0000 0000 0000 0000 0000 0000 0000 0000 0000 0000 0000 0000 0000 0000 0000 0000 0000 0000 0000 0000 0000 0000 0000 0000 0000 0000 0000 0000 0000 4108
4108 0000 0000 0000 0000 0000 0000 0000 0000 0000 0000 0000 0000 0000 0000 0000 0000 0000 0000 0000 0000 0000 0000 0000 0000 0000 0000 0000 0000 0000 0000 0000 0000 0000 0000 2612 2613 2613 2613 2613 2613 2613 2613 0000 0000 0000 0000 0000 0000 4108
4108 0000 0000 0000 0000 0000 0000 0000 0000 0000 0000 0000 0000 0000 0000 0000 0000 0000 0000 0000 0000 0000 0000 0000 0000 0000 0000 0000 0000 0000 0000 0000 0000 0000 0000 2740 2741 2741 2741 2741 2741 2741 2741 0000 0000 0000 0000 0000 0000 4108
4108 0000 0000 0000 0000 0000 0000 0000 0000 0000 0000 0000 0000 0000 0000 0000 0000 0000 0000 0000 0000 0000 0000 0000 0000 0000 0000 0000 0000 0000 0000 0000 0000 0000 0000 2852 2853 2853 2853 2853 2853 2853 2854 0000 0000 0000 0000 0000 0000 4108
4108 0000 0000 0000 0000 0000 3104 3105 3105 3105 3105 3105 3106 0000 0000 0000 0000 0000 0000 0000 0000 0000 0000 0000 0000 0000 0000 0000 0000 0000 0000 0000 0000 0000 0000 2916 2917 2917 2917 2917 2917 2917 2918 0000 0000 0000 0000 0000 0000 4108
4108 0000 0000 0000 0000 0000 3232 3233 3233 3233 3233 3233 3234 4356 5512 0000 0000 0000 0000 0000 0000 0000 0000 0000 0000 0000 0000 0000 0000 0000 0000 0000 0000 0000 0000 2916 2917 2917 2917 2917 2917 2917 2918 0000 0000 0000 0000 0000 0000 4108
4108 0000 0000 0000 0000 0000 3360 3361 3361 3361 3361 3361 3362 4356 0000 0000 0000 0000 0000 0000 0000 0000 0000 0000 0000 0000 0000 0000 0000 0000 0000 0000 0000 0000 0000 2980 2981 2981 2981 2981 2981 2981 2982 0000 0000 0000 0000 0000 0000 4108
4108 0000 0000 0000 0000 0000 3488 3489 3489 3489 3489 3489 3490 0000 0000 0000 0000 0000 0000 0000 0000 0000 0000 0000 0000 0000 0000 0000 0000 0000 0000 0000 0000 0000 0000 0000 0000 0000 0000 0000 0000 0000 0000 0000 0000 0000 0000 0000 0000 4108
4108 0000 0000 0000 0000 0000 0000 0000 0000 0000 0000 0000 0000 0000 0000 0000 0000 0000 0000 0000 0000 0000 0000 0000 0000 0000 0000 0000 0000 0000 0000 0000 0000 0000 0000 0000 0000 0000 0000 0000 0000 0000 0000 0000 0000 0000 0000 0000 0000 4108
4108 0000 0000 0000 0000 0000 0000 0000 0000 0000 0000 0000 0000 0000 0000 0000 0000 0000 0000 0000 0000 0000 0000 0000 0000 0000 0000 0000 0000 0000 0000 0000 0000 0000 0000 0000 0000 0000 0000 0000 0000 0000 0000 0000 0000 0000 0000 0000 0000 4108
4108 4106 4106 4106 4106 4106 4106 4106 4106 4106 4106 4106 4106 4106 4106 4106 4106 4106 4106 4106 4106 4106 4106 4106 4106 4106 4106 4106 4106 4106 4106 4106 4106 4106 4106 4106 4106 4106 4106 4106 4106 4106 4106 4106 4106 4106 4106 4106 4106 4108
4234 4234 4234 4234 4234 4234 4234 4234 4234 4234 4234 4234 4234 4234 4234 4234 4234 4234 4234 4234 4234 4234 4234 4234 4234 4234 4234 4234 4234 4234 4234 4234 4234 4234 4234 4234 4234 4234 4234 4234 4234 4234 4234 4234 4234 4234 4234 4234 4234 4234
-----
0000 0000 0000 0000 0000 0000 0000 0000 0000 0000 0000 0000 0000 0000 0000 0000 0000 0000 0000 0000 0000 0000 0000 0000 0000 0000 0000 0000 0000 0000 0000 0000 0000 0000 0000 0000 0000 0000 0000 0000 0000 0000 0000 0000 0000 0000 0000 0000 0000 0000
0000 0000 0000 0000 0000 0000 0000 0000 0000 0000 0000 0000 0000 0000 0000 0000 0000 0000 0000 0000 0000 0000 0000 0000 0000 0000 0000 0000 0000 0000 0000 0000 0000 0000 0000 0000 0000 0000 0000 0000 0000 0000 0000 0000 0000 0000 0000 0000 0000 0000
0000 0000 0000 0000 0000 0000 0000 0000 0000 0000 0000 0000 0000 0000 0000 0000 0000 0000 0000 0000 0000 0000 0000 0000 0000 0000 0000 0000 0000 0000 0000 0000 0000 0000 0000 0000 0000 0000 0000 0000 0000 0000 0000 0000 0000 0000 0000 0000 0000 0000
0000 0000 0000 0000 0000 0000 0000 0000 0000 0000 0000 0000 0000 0000 0000 0000 0000 0000 0000 0000 0000 0000 0000 0000 0000 0000 0000 0000 0000 0000 0000 0000 0000 0000 0000 0000 0000 0000 0000 0000 0000 0000 0000 0000 0000 0000 0000 0000 0000 0000
0000 0000 0000 0000 0000 0000 0000 0000 0000 0000 0000 0000 0000 0000 0000 0000 0000 0000 0000 0000 0000 0000 0000 0000 0000 0000 0000 0000 0000 0000 0000 0000 0000 0000 0000 0000 0000 0000 0000 0000 0000 0000 0000 0000 0000 0000 0000 0000 0000 0000
0000 0000 0000 0000 0000 0000 0000 0000 0000 0000 0000 0000 0000 0000 0000 0000 0000 0000 0000 0000 0000 0000 0000 0000 0000 0000 0000 0000 0000 0000 0000 0000 0000 0000 0000 0000 0000 0000 0000 0000 0000 0000 0000 0000 0000 0000 0000 0000 0000 0000
0000 0000 0000 0000 0000 0000 0000 0000 0000 0000 0000 0000 0000 0000 0000 0000 0000 0000 0000 0000 0000 0000 0000 2074 0000 0000 0000 0000 0000 2328 0000 0000 0000 0000 0000 0000 0000 0000 0000 0000 0000 0000 0000 0000 0000 0000 0000 0000 0000 0000
0000 0000 0000 0000 0000 0000 0000 0000 0000 0000 0000 0000 0000 0000 0000 0000 0000 0000 0000 0000 0000 0000 0000 2202 0000 0000 0000 0000 0000 2456 0000 0000 0000 0000 0000 0000 0000 0000 0000 0000 0000 0000 0000 0000 0000 0000 0000 0000 0000 0000
0000 0000 0000 0000 0000 0000 0000 0000 0000 0000 0000 0000 0000 0000 0000 0000 0000 0000 0000 0000 0000 0000 0000 0000 0000 0000 0000 0000 0000 0000 0000 0000 0000 0000 0000 0000 0000 0000 0000 0000 0000 0000 0000 0000 0000 0000 0000 0000 0000 0000
0000 0000 0000 0000 0000 0000 0000 0000 0000 0000 0000 0000 0000 0000 0000 0000 0000 0000 0000 0000 0000 2332 2334 0000 0000 0000 3790 0000 0000 0000 2332 2334 0000 0000 0000 0000 0000 0000 0000 0000 0000 0000 0000 0000 0000 0000 0000 0000 0000 0000
0000 0000 0000 0000 0000 0000 0000 0000 0000 0000 0000 0000 0000 0000 0000 0000 0000 0000 0000 0000 0000 2716 2718 0000 0000 0000 3848 0000 0000 0000 2716 2718 0000 0000 0000 0000 0000 0000 0000 0000 0000 0000 0000 0000 0000 0000 0000 0000 0000 0000
0000 0000 0000 0000 0000 0000 0000 0000 0000 0000 0000 0000 0000 0000 0000 0000 0000 0000 0000 0000 0000 0000 0000 0000 0000 0000 0000 0000 0000 0000 0000 0000 0000 0000 0000 0000 0000 0000 0000 0000 0000 0000 0000 0000 0000 0000 0000 0000 0000 0000
0000 0000 0000 0000 0000 0000 0000 0000 0000 0000 0000 0000 0000 0000 0000 0000 0000 0000 0000 0000 0000 0000 0000 0000 0000 0000 0000 0000 0000 0000 0000 0000 0000 0000 0000 0000 0000 0000 0000 0000 0000 0000 0000 0000 0000 0000 0000 0000 0000 0000
0000 0000 0000 0000 0000 0000 0000 0000 0000 0000 0000 0000 0000 0000 0000 0000 0000 0000 0000 0000 0000 0000 0000 0000 0000 0000 0000 0000 0000 0000 0000 0000 0000 0000 0000 0000 0000 0000 0000 0000 0000 0000 0000 0000 0000 0000 0000 0000 0000 0000
0000 0000 0000 0000 0000 0000 0000 0000 0000 0000 0000 0000 0000 0000 0000 0000 0000 0000 0000 0000 0000 0000 0000 0000 0000 0000 0000 0000 0000 0000 0000 0000 0000 0000 0000 0000 0000 0000 0000 0000 0000 0000 0000 0000 0000 0000 0000 0000 0000 0000
0000 0000 0000 0000 6170 6298 6300 6174 0000 0000 3790 0000 0000 0000 0000 0000 0000 0000 0000 0000 0000 0000 0000 0000 0000 0000 0000 0000 0000 0000 0000 0000 0000 0000 0000 0000 0000 0000 0000 0000 0000 0000 0000 0000 0000 0000 0000 0000 0000 0000
0000 0000 0000 0000 0000 0000 0000 0000 0000 0000 3848 0000 0000 0000 0000 0000 0000 0000 0000 0000 0000 0000 0000 0000 0000 0000 0000 0000 0000 0000 0000 0000 0000 0000 0000 0000 0000 0000 0000 0000 0000 0000 0000 0000 0000 0000 0000 0000 0000 0000
0000 0000 0000 0000 0000 0000 0000 0000 0000 0000 0000 0000 0000 0000 0000 0000 0000 0000 0000 0000 0000 0000 0000 0000 0000 0000 0000 0000 0000 0000 0000 0000 0000 0000 0000 0000 0000 0000 0000 0000 0000 0000 0000 0000 0000 0000 0000 0000 0000 0000
0000 0000 0000 0000 0000 0000 0000 0000 0000 0000 0000 0000 0000 0000 0000 0000 0000 0000 0000 0000 0000 0000 0000 0000 0000 0000 0000 0000 0000 0000 0000 0000 0000 0000 0000 0000 0000 0000 0000 0000 0000 0000 0000 0000 0000 0000 0000 0000 0000 0000
0000 0000 0000 0000 0000 0000 0000 0000 0000 0000 0000 0000 0000 0000 0000 0000 0000 0000 0000 0000 0000 0000 0000 0000 0000 0000 0000 0000 0000 0000 0000 0000 0000 0000 0000 0000 0000 0000 0000 0000 0000 0000 0000 0000 0000 0000 0000 0000 0000 0000
0000 0000 0000 0000 0000 0000 0000 0000 0000 0000 0000 0000 0000 0000 0000 0000 0000 0000 0000 0000 0000 0000 0000 0000 0000 0000 0000 0000 0000 0000 0000 0000 0000 0000 0000 0000 0000 0000 0000 0000 0000 0000 0000 0000 0000 0000 0000 0000 0000 0000
0000 0000 0000 0000 0000 0000 0000 0000 0000 0000 0000 0000 0000 0000 0000 0000 0000 0000 0000 0000 0000 0000 0000 0000 0000 0000 0000 0000 0000 0000 0000 0000 0000 0000 0000 0000 0000 0000 0000 0000 0000 0000 0000 0000 0000 0000 0000 0000 0000 0000
0000 0000 0000 0000 0000 0000 0000 0000 0000 0000 0000 0000 0000 0000 0000 0000 0000 0000 0000 0000 0000 0000 0000 0000 0000 0000 0000 0000 0000 0000 0000 0000 0000 0000 0000 0000 2328 0000 2328 0000 0000 2824 0000 0000 0000 0000 0000 0000 0000 0000
0000 0000 0000 0000 0000 0000 0000 0000 0000 0000 0000 0000 0000 0000 0000 0000 0000 0000 0000 0000 0000 0000 0000 0000 0000 0000 0000 0000 0000 0000 0000 0000 0000 0000 0000 0000 2456 0000 2456 0000 3790 0000 0000 0000 0000 0000 0000 0000 0000 0000
0000 0000 0000 0000 0000 0000 0000 3584 0000 0000 3790 0000 0000 0000 0000 0000 0000 0000 0000 0000 0000 0000 0000 0000 0000 0000 0000 0000 0000 0000 0000 0000 0000 0000 0000 0000 0000 0000 0000 0000 3848 0000 0000 0000 0000 0000 0000 0000 0000 0000
0000 0000 0000 0000 0000 0000 0000 3586 0000 0000 3848 0000 0000 0000 0000 0000 0000 0000 0000 0000 0000 0000 0000 0000 0000 0000 0000 0000 0000 0000 0000 0000 0000 0000 0000 0000 0000 0000 0000 0000 0000 0000 0000 0000 0000 0000 0000 0000 0000 0000
0000 0000 0000 0000 0000 0000 0000 0000 0000 0000 0000 0000 0000 0000 0000 0000 0000 0000 0000 0000 0000 0000 0000 0000 0000 0000 0000 0000 0000 0000 0000 0000 0000 0000 0000 0000 0000 0000 0000 0000 0000 0000 0000 0000 0000 0000 0000 0000 0000 0000
0000 0000 0000 0000 0000 0000 0000 0000 0000 0000 0000 0000 0000 0000 0000 0000 0000 0000 0000 0000 0000 0000 0000 0000 0000 0000 0000 0000 0000 0000 0000 0000 0000 0000 0000 0000 0000 0000 0000 0000 0000 0000 0000 0000 0000 0000 0000 0000 0000 0000
0000 0000 0000 0000 0000 0000 0000 0000 0000 0000 0000 0000 0000 0000 0000 0000 0000 0000 0000 0000 0000 0000 0000 0000 0000 0000 0000 0000 0000 0000 0000 0000 0000 0000 0000 0000 0000 0000 0000 0000 0000 0000 0000 0000 0000 0000 0000 0000 0000 0000
0000 0000 0000 0000 0000 0000 0000 0000 0000 0000 0000 0000 0000 0000 0000 0000 0000 0000 0000 0000 0000 0000 0000 0000 0000 0000 0000 0000 0000 0000 0000 0000 0000 0000 0000 0000 0000 0000 0000 0000 0000 0000 0000 0000 0000 0000 0000 0000 0000 0000